Receipt No.,Account,Transaction_Type,Money_In,Money_Out,Balance,DayOfWeekName,Completion Time
F50XFOOQHS,John Roberson,Send Money,0.0,50.0,4006.6,Tuesday,2024-03-19 19:24:09
MCN4LTSMZ3,Mpesa Charges,Mpesa Charges,0.0,7.0,4056.6,Sunday,2024-03-17 19:49:25
QKA0NKC6Q9,John Roberson,Send Money,0.0,120.0,4063.6,Sunday,2024-03-17 19:49:25
7OVHSJKPNT,Michael Sanchez,Send Money,0.0,60.0,4183.6,Sunday,2024-03-17 19:46:48
IG929YGH1K,Mpesa Charges,Mpesa Charges,0.0,7.0,4243.6,Sunday,2024-03-17 19:44:25
54G1VBEB2A,Alicia Chapman,Send Money,0.0,150.0,4250.6,Sunday,2024-03-17 19:44:25
JGTMEV5R95,Airtime Purchase,Airtime Purchase,0.0,50.0,4400.6,Sunday,2024-03-17 19:06:48
M40QEH429M,Reeves-Copeland,Till No,0.0,1675.0,4450.6,Sunday,2024-03-17 18:59:24
3B4ZRLSRAN,Mpesa Charges,Mpesa Charges,0.0,21.19,1530.6,Sunday,2024-03-17 15:04:21
O2UZVRRKH0,"Vega, Levine and Benjamin",Till No,0.0,3854.0,1551.79,Sunday,2024-03-17 15:04:21
29QEGQKPK3,"Smith, Mcknight and Brown",Till No,0.0,170.0,5405.79,Saturday,2024-03-16 19:23:11
2XVSIJIYBK,Daniel Ellis,Send Money,0.0,100.0,5575.79,Saturday,2024-03-16 13:56:55
NBDTUMEXCH,Jasmine Alvarado,Send Money,0.0,60.0,5675.79,Saturday,2024-03-16 12:29:59
GNPBCEVWYB,Mpesa Charges,Mpesa Charges,0.0,33.0,5735.79,Saturday,2024-03-16 09:01:51
V4HU0IS8TL,"Smith, Mcknight and Brown",Till No,0.0,135.0,7418.79,Friday,2024-03-15 19:32:43
7W269AYNI0,Alexis Gutierrez,Send Money,0.0,70.0,7553.79,Thursday,2024-03-14 22:35:57
NUZOK2IJJY,Tina Carter,Pochi,0.0,60.0,7623.79,Thursday,2024-03-14 22:16:10
P6VAOXFXPP,Mpesa Charges,Mpesa Charges,0.0,7.0,7683.79,Thursday,2024-03-14 21:41:04
Z0P0KKCA77,"Franklin, Hatfield and Wilson",Till No,0.0,450.0,7950.79,Thursday,2024-03-14 15:58:38
IRLCUTES4L,"Smith, Fisher and Cruz",Till No,0.0,260.0,8400.79,Thursday,2024-03-14 15:39:07
O0412P671P,Moran LLC,Till No,0.0,250.0,8660.79,Wednesday,2024-03-13 18:48:55
C2O3EI5U6G,"Hill, Matthews and Martin",Till No,0.0,300.0,8910.79,Wednesday,2024-03-13 13:03:02
T03I6WMKJE,Mpesa Charges,Mpesa Charges,0.0,5.0,9210.79,Wednesday,2024-03-13 13:00:37
4BPY0CDPFE,Yates-Dunn,Pay Bill,0.0,200.0,9215.79,Wednesday,2024-03-13 13:00:37
UX4GQNHETH,"Franklin, Hatfield and Wilson",Till No,0.0,510.0,9415.79,Wednesday,2024-03-13 12:51:00
4N0E5Z6SLE,"Carlson, Hanson and Martin",Till No,0.0,145.0,9925.79,Tuesday,2024-03-12 19:32:12
25CUTPGGDR,"Smith, Mcknight and Brown",Till No,0.0,60.0,10070.79,Tuesday,2024-03-12 19:29:29
8IY5E8655E,Mpesa Charges,Mpesa Charges,0.0,7.0,10170.79,Monday,2024-03-11 19:44:47
MCY5PYM3KB,Mr. Ryan Keith DVM,Send Money,0.0,140.0,10177.79,Monday,2024-03-11 19:44:47
RQBYD1FT32,Lopez LLC,Till No,0.0,330.0,10317.79,Monday,2024-03-11 07:59:07
RI2TATSX74,Gibbs Group,Till No,0.0,270.0,10647.79,Sunday,2024-03-10 19:59:38
ZEF0WHXPWI,"Franklin, Hatfield and Wilson",Till No,0.0,360.0,10917.79,Sunday,2024-03-10 12:29:04
I82A57WBPV,Keith Kelly,Send Money,0.0,80.0,11277.79,Sunday,2024-03-10 11:27:09
TR15651A4Z,Leblanc LLC,Till No,0.0,100.0,11357.79,Sunday,2024-03-10 09:28:23
J65VTH12T6,Bryan Salas,Send Money,0.0,250.0,11464.79,Saturday,2024-03-09 12:31:05
7O4XRQCE5D,Mpesa Charges,Mpesa Charges,0.0,7.0,11714.79,Saturday,2024-03-09 12:24:46
L24AKRC7WJ,Mpesa Charges,Mpesa Charges,0.0,10.0,11921.79,Saturday,2024-03-09 11:59:56
KJF1BD05I1,Washington-Crawford,Pay Bill,0.0,1400.0,11931.79,Saturday,2024-03-09 11:59:56
FK1ASRBDLU,Moreno Group,Bank Transfer,10000.0,0.0,13331.79,Saturday,2024-03-09 11:43:33
IF32K347YG,Philip Roberts,Send Money,0.0,10.0,3331.79,Saturday,2024-03-09 10:37:17
X1Z5XCZSXQ,Baker Group,Till No,0.0,100.0,3341.79,Saturday,2024-03-09 10:26:05
KR69QN3D5U,"Smith, Mcknight and Brown",Till No,0.0,70.0,3441.79,Friday,2024-03-08 20:01:20
6G7QDYRBAL,Michael Sanchez,Send Money,0.0,100.0,3511.79,Friday,2024-03-08 19:58:48
XUW102SLPK,"Smith, Mcknight and Brown",Till No,0.0,35.0,3611.79,Thursday,2024-03-07 20:15:38
QW089EPY9A,Mpesa Charges,Mpesa Charges,0.0,7.0,3646.79,Thursday,2024-03-07 20:13:04
QIED5F9EIF,Alicia Chapman,Send Money,0.0,150.0,3653.79,Thursday,2024-03-07 20:13:04
Q5OD70U5HM,Alicia Chapman,Send Money,0.0,50.0,5256.79,Wednesday,2024-03-06 18:58:46
1ZFNAYCIGR,Mpesa Charges,Mpesa Charges,0.0,10.0,5306.79,Wednesday,2024-03-06 08:35:53
0ZP9SG1HI5,White-Fowler,Pay Bill,0.0,700.0,5316.79,Wednesday,2024-03-06 08:35:53
VOLS1NOU0X,Mpesa Charges,Mpesa Charges,0.0,10.0,6016.79,Wednesday,2024-03-06 08:35:29
VK4H49A68K,"Smith, Mcknight and Brown",Till No,0.0,20.0,6826.79,Tuesday,2024-03-05 18:12:11
WRG6DMWYSA,Benjamin Villanueva,Send Money,0.0,50.0,6846.79,Tuesday,2024-03-05 18:09:23
B0NQ53973A,Mpesa Charges,Mpesa Charges,0.0,7.0,6896.79,Tuesday,2024-03-05 18:08:08
5UHD64KOS9,John Roberson,Send Money,0.0,150.0,6903.79,Tuesday,2024-03-05 18:08:08
CLUWL6QZEX,Joseph Perez,Send Money,0.0,850.0,10065.79,Monday,2024-03-04 20:24:43
BNNTB8HU92,Dorothy Price,Send Money,0.0,850.0,10065.79,Monday,2024-03-04 20:24:43
0OJRMVLSQH,"Hill, Matthews and Martin",Till No,0.0,300.0,10915.79,Monday,2024-03-04 18:59:21
RZAXQ8M17L,Other,Other,0.0,1000.0,11215.79,Monday,2024-03-04 18:35:45
49TQZ4PXVC,Mpesa Charges,Mpesa Charges,0.0,7.0,12215.79,Monday,2024-03-04 18:27:01
PN44YMNWZI,John Roberson,Send Money,0.0,140.0,12222.79,Monday,2024-03-04 18:27:01
HR92ABLV89,Smith-Lane,Till No,0.0,200.0,12362.79,Monday,2024-03-04 18:22:54
WUJUAWT1WL,Miller-Gallagher,Till No,0.0,3000.0,1238.86,Sunday,2024-03-03 18:02:20
1VD2KPH7CZ,Mpesa Charges,Mpesa Charges,0.0,10.0,4238.86,Sunday,2024-03-03 10:05:04
3N7SC3R7UV,Marshall-Gibson,Pay Bill,0.0,978.0,4248.86,Sunday,2024-03-03 10:05:04
K2UBEWBVBP,Wallace PLC,Till No,0.0,7270.0,5276.84,Sunday,2024-03-03 07:31:27
EQYRQBLLW2,Jennifer Moreno,Send Money,0.0,50.0,12546.84,Saturday,2024-03-02 22:03:38
I688O2NOKI,Mark Dickson,Send Money,0.0,50.0,13751.84,Saturday,2024-03-02 21:38:50
LRVXBLO7VS,Mpesa Charges,Mpesa Charges,0.0,83.0,13801.84,Saturday,2024-03-02 21:11:09
1VEHFDS7V6,"Caldwell, King and Taylor",Pay Bill,0.0,31500.0,13884.84,Saturday,2024-03-02 21:11:09
J7BKY1CMIQ,Turner Inc,Bank Transfer,45000.0,0.0,45384.84,Saturday,2024-03-02 21:09:41
TF07FCIUM3,Shwari Loan Repayment,MShwari Loan,0.0,3270.0,504.84,Saturday,2024-03-02 17:58:05
4QHK091RQB,"Smith, Mcknight and Brown",Till No,0.0,90.0,3774.84,Friday,2024-03-01 20:20:08
IKFUOQNDZ2,Mpesa Charges,Mpesa Charges,0.0,5.0,3864.84,Thursday,2024-02-29 19:43:24
8WIGGZ9CWK,White-Fowler,Pay Bill,0.0,500.0,3869.84,Thursday,2024-02-29 19:43:24
USAJUC91KU,Alicia Chapman,Send Money,0.0,50.0,4369.84,Thursday,2024-02-29 18:27:07
LAQP7VHKWN,Smith-Lane,Till No,0.0,200.0,4419.84,Thursday,2024-02-29 18:24:16
BJE7ZMGAJA,"Franklin, Hatfield and Wilson",Till No,0.0,310.0,4619.84,Thursday,2024-02-29 18:15:45
XIUHIC9MW6,Mpesa Charges,Mpesa Charges,0.0,33.0,4929.84,Wednesday,2024-02-28 20:52:53
QPJA0V5H5M,Brian Nguyen,Send Money,0.0,1530.0,4962.84,Wednesday,2024-02-28 20:52:53
ZO12VE1DCG,"Carlson, Hanson and Martin",Till No,0.0,200.0,6492.84,Wednesday,2024-02-28 20:42:22
WPTW2WOPXP,Mpesa Charges,Mpesa Charges,0.0,7.0,6692.84,Wednesday,2024-02-28 19:59:38
BF48L7FW87,Chad Bradley,Send Money,0.0,350.0,6699.84,Wednesday,2024-02-28 19:59:38
FNW03PVFG4,Joseph Perez,Receive Money,2500.0,0.0,7049.84,Wednesday,2024-02-28 15:50:28
6ZWKFWKF6V,Dorothy Price,Receive Money,2500.0,0.0,7049.84,Wednesday,2024-02-28 15:50:28
H0AGOVBZUL,"Franklin, Hatfield and Wilson",Till No,0.0,400.0,4549.84,Wednesday,2024-02-28 14:03:56
6T7LCH6YM9, M-PESA Overdraw,Fuliza Loan Repayment,0.0,50.16,4949.84,Wednesday,2024-02-28 13:50:59
LC6OSXCP0K,Parker-Avila,Bank Transfer,5000.0,0.0,5000.0,Wednesday,2024-02-28 13:50:58
JB6X7B5PLW,"Lee, Greer and Mccullough",Till No,0.0,369.0,0.0,Tuesday,2024-02-27 16:36:09
AG56DKVPRC,Fuliza Loan,Fuliza Loan,49.66,0.0,369.0,Tuesday,2024-02-27 16:36:09
T0SDPZPZ07,Mpesa Charges,Mpesa Charges,0.0,33.0,319.34,Tuesday,2024-02-27 13:16:42
MHF2YEQQCJ,Jesse Thompson,Send Money,0.0,2035.0,352.34,Tuesday,2024-02-27 13:16:42
5ENFOXJMD6,Shwari Withdraw,Mshwari Withdraw,700.0,0.0,2387.34,Tuesday,2024-02-27 13:14:57
28ISBC28HO,Mpesa Charges,Mpesa Charges,0.0,33.0,1687.34,Sunday,2024-02-25 13:46:45
LHZB60CM4N,Joseph Perez,Send Money,0.0,2000.0,1720.34,Sunday,2024-02-25 13:46:45
NOSM0P3EXR,Dorothy Price,Send Money,0.0,2000.0,1720.34,Sunday,2024-02-25 13:46:45
KJ3Y8UD46S,Wells-Day,Till No,0.0,200.0,3720.34,Saturday,2024-02-24 21:12:04
I3Z3UJ2X0W,Mpesa Charges,Mpesa Charges,0.0,34.0,3920.34,Saturday,2024-02-24 20:33:46
DK4MBSJ3VS,Williams and Sons,Pay Bill,0.0,4516.0,3954.34,Saturday,2024-02-24 20:33:46
INK6CECB46,Mpesa Charges,Mpesa Charges,0.0,7.0,8470.34,Saturday,2024-02-24 20:19:27
3PW71NYVJW,Michael Sanchez,Send Money,0.0,140.0,8477.34,Saturday,2024-02-24 20:19:27
2ER32SF4Y0,Kim LLC,Bank Transfer,5000.0,0.0,8617.34,Saturday,2024-02-24 20:13:56
AWAC0XHJGM,"Hill, Matthews and Martin",Till No,0.0,300.0,3617.34,Saturday,2024-02-24 15:49:59
VV2PJ1ZG4H,Mpesa Charges,Mpesa Charges,0.0,33.0,3917.34,Friday,2024-02-23 23:24:45
2WEFX4JKE8,Joseph Perez,Send Money,0.0,1550.0,3950.34,Friday,2024-02-23 23:24:45
Z71Z6SWPHR,Dorothy Price,Send Money,0.0,1550.0,3950.34,Friday,2024-02-23 23:24:45
OVY7A1AV2W,Vargas-Skinner,Bank Transfer,5000.0,0.0,5500.34,Friday,2024-02-23 23:24:26
LQZNVS36Z6,"Smith, Mcknight and Brown",Till No,0.0,90.0,500.34,Friday,2024-02-23 19:25:35
46E4ZYHO3Z,Mpesa Charges,Mpesa Charges,0.0,7.0,590.34,Friday,2024-02-23 19:22:38
EFJT1E247T,Michael Sanchez,Send Money,0.0,145.0,597.34,Friday,2024-02-23 19:22:38
OIVVTUKBD0,Norris-Watts,Till No,0.0,550.0,742.34,Friday,2024-02-23 19:15:10
EOKN2XIQC9,Chloe Smith,Send Money,0.0,50.0,1292.34,Friday,2024-02-23 13:54:55
11NG3GVRMW,Mpesa Charges,Mpesa Charges,0.0,27.5,1342.34,Friday,2024-02-23 13:51:55
19TLE617KE,Wallace PLC,Till No,0.0,5000.0,1369.84,Friday,2024-02-23 13:51:55
59ZOLLIES4,Mpesa Charges,Mpesa Charges,0.0,7.0,9504.84,Friday,2024-02-23 12:00:04
2MYZV96W9I,David Lewis,Send Money,0.0,150.0,9511.84,Friday,2024-02-23 12:00:04
U8WWIUCOVG,Miller-Torres,Till No,0.0,40.0,9661.84,Friday,2024-02-23 11:14:03
I8CPORJZ3A,Mpesa Charges,Mpesa Charges,0.0,33.0,9701.84,Friday,2024-02-23 10:52:10
6UNPY7PAHG,Gabriel Singleton,Send Money,0.0,1600.0,9734.84,Friday,2024-02-23 10:52:10
S6CMSLBD1R,"Pratt, Brown and Wilson",Bank Transfer,10000.0,0.0,11334.84,Friday,2024-02-23 10:48:35
0XP2G3GYPJ,Travis Escobar,Send Money,0.0,65.0,1334.84,Friday,2024-02-23 08:27:06
QP2BU9ZSP0,Madison Pugh,Send Money,0.0,100.0,1399.84,Thursday,2024-02-22 21:17:16
WBFMNK54LA,Lopez LLC,Till No,0.0,640.0,1499.84,Thursday,2024-02-22 21:13:12
KGXDPAXYUK,Lopez LLC,Till No,0.0,300.0,2139.84,Thursday,2024-02-22 14:37:20
63JLEQQKE7,Mpesa Charges,Mpesa Charges,0.0,7.0,2439.84,Wednesday,2024-02-21 19:11:12
XDTAIAGULY,"Franklin, Hatfield and Wilson",Till No,0.0,120.0,2566.84,Wednesday,2024-02-21 19:02:23
F946VWXG9S,Mpesa Charges,Mpesa Charges,0.0,53.0,2686.84,Tuesday,2024-02-20 22:21:17
2EOL68WBLZ,Richard Melendez,Send Money,0.0,3000.0,2739.84,Tuesday,2024-02-20 22:21:17
L22GG3F9K1,Boyer and Sons,Bank Transfer,5000.0,0.0,5739.84,Tuesday,2024-02-20 22:20:15
IBR6RG7W3D,Michael Sanchez,Send Money,0.0,30.0,739.84,Tuesday,2024-02-20 19:45:27
CGN2XSU5XA,"Perry, Leach and Mata",Till No,0.0,615.0,769.84,Tuesday,2024-02-20 19:17:04
DAF997HPE0,Mpesa Charges,Mpesa Charges,0.0,13.0,1384.84,Tuesday,2024-02-20 12:23:57
IGI7V85LE7,Angela Meyer,Send Money,0.0,776.0,1397.84,Tuesday,2024-02-20 12:23:57
YZ0JQ32PSW,Joseph Perez,Receive Money,780.0,0.0,2173.84,Tuesday,2024-02-20 12:20:03
BURCUB75MS,Dorothy Price,Receive Money,780.0,0.0,2173.84,Tuesday,2024-02-20 12:20:03
CJS0SEIET7,Travis Escobar,Send Money,0.0,65.0,1393.84,Tuesday,2024-02-20 10:08:06
LBEDA85P92,Mpesa Charges,Mpesa Charges,0.0,7.0,1458.84,Monday,2024-02-19 19:32:35
A7ON3IRCM3,Michael Sanchez,Send Money,0.0,160.0,1465.84,Monday,2024-02-19 19:32:35
NFWDSCSX5W,Mpesa Charges,Mpesa Charges,0.0,13.0,1625.84,Sunday,2024-02-18 20:12:26
Q97OH9PUQV,Mpesa Charges,Mpesa Charges,0.0,7.0,2638.84,Sunday,2024-02-18 19:45:55
WGL0B1RY7E,Erin Washington,Send Money,0.0,110.0,2645.84,Sunday,2024-02-18 19:45:55
4XBOCTV8TB,Newman Inc,Pay Bill,0.0,100.0,2755.84,Sunday,2024-02-18 17:01:17
YNOFQ1LPF8,Mpesa Charges,Mpesa Charges,0.0,78.0,2855.84,Sunday,2024-02-18 12:46:50
YF0RRAO1R8,Stephanie Butler,Send Money,0.0,6200.0,2933.84,Sunday,2024-02-18 12:46:50
M8D5MRTAAU,Stacey Fletcher,Receive Money,7000.0,0.0,9133.84,Sunday,2024-02-18 12:44:33
YJ9W1Y8CDW,Mpesa Charges,Mpesa Charges,0.0,5.0,2133.84,Saturday,2024-02-17 19:30:47
6JKBU2GTA4,Newman Inc,Pay Bill,0.0,160.0,2138.84,Saturday,2024-02-17 19:30:47
LSEXQ4UC5Z,"Smith, Mcknight and Brown",Till No,0.0,30.0,2298.84,Saturday,2024-02-17 19:29:14
0TKI87JZBZ,Benjamin Villanueva,Send Money,0.0,30.0,2328.84,Saturday,2024-02-17 17:40:11
HUD4JCUPYJ,Mpesa Charges,Mpesa Charges,0.0,7.0,2358.84,Saturday,2024-02-17 02:31:29
EBHJL5UWMM,Hector Kramer,Send Money,0.0,450.0,2365.84,Saturday,2024-02-17 02:31:29
X5GUJS3FNW,Theresa Kelly,Send Money,0.0,450.0,2365.84,Saturday,2024-02-17 02:31:29
ZXL8L827IQ,Mpesa Charges,Mpesa Charges,0.0,7.0,2815.84,Friday,2024-02-16 21:17:30
N92KY0T3HV,Michael Suarez,Send Money,0.0,500.0,2822.84,Friday,2024-02-16 21:17:30
SO4SBMPOMI,Derrick Fischer,Send Money,0.0,500.0,2822.84,Friday,2024-02-16 21:17:30
3IHNBZL32G,April Bennett,Pochi,0.0,30.0,3322.84,Friday,2024-02-16 17:44:40
MGYYW4S38V,Mpesa Charges,Mpesa Charges,0.0,23.0,3352.84,Friday,2024-02-16 16:04:09
Q9NBX0RBCV,Adam Burns,Send Money,0.0,1500.0,3375.84,Friday,2024-02-16 16:04:09
LQVSPOC6BC,Mpesa Charges,Mpesa Charges,0.0,21.07,4875.84,Friday,2024-02-16 13:19:03
1PB0H7KOP0,Wallace PLC,Till No,0.0,3831.0,4896.91,Friday,2024-02-16 13:19:03
01GA5GQHWC,Shwari Loan Request,MShwari Loan,0.0,0.0,8727.91,Friday,2024-02-16 12:52:32
ZX6HKPWLUF,Shwari Loan Disburse,MShwari Loan,3000.0,0.0,8727.91,Friday,2024-02-16 12:52:32
2EZLKA0OIY,Mpesa Charges,Mpesa Charges,0.0,53.0,727.91,Friday,2024-02-16 10:46:47
8A3BEIL42I,Adam Burns,Send Money,0.0,3000.0,780.91,Friday,2024-02-16 10:46:47
SM1VTG8M49,Mpesa Charges,Mpesa Charges,0.0,13.0,3780.91,Friday,2024-02-16 10:28:16
DRYTYAW0I0,Vincent Tapia,Send Money,0.0,870.0,3793.91,Friday,2024-02-16 10:28:16
6DY0MG115Z,Buck Group,Till No,0.0,335.0,4663.91,Thursday,2024-02-15 14:55:36
Z74Z5LLUSJ, M-PESA Overdraw,Fuliza Loan Repayment,0.0,1.09,4998.91,Thursday,2024-02-15 14:53:42
IL6TOHHA6B,Wheeler-Simmons,Bank Transfer,5000.0,0.0,5000.0,Thursday,2024-02-15 14:53:42
YSPKC19JTZ,Mpesa Charges,Mpesa Charges,0.0,13.0,0.0,Wednesday,2024-02-14 19:55:37
6Z1H9YTSR2,Regina Miller DDS,Send Money,0.0,810.0,13.0,Wednesday,2024-02-14 19:55:37
3E84Y6WI1E,Fuliza Loan,Fuliza Loan,1.07,0.0,823.0,Wednesday,2024-02-14 19:55:37
W3IB1Z8EV9,Manning-Khan,Till No,0.0,2850.0,821.93,Wednesday,2024-02-14 16:24:32
FDM8YVAMY1,"Hill, Matthews and Martin",Till No,0.0,300.0,3671.93,Wednesday,2024-02-14 10:22:56
NCSMVHK7JZ,"Brown, Garcia and Wong",Till No,0.0,5550.0,3971.93,Tuesday,2024-02-13 11:13:25
QNY8ANNZMP,Daniels LLC,Bank Transfer,5000.0,0.0,9521.93,Tuesday,2024-02-13 11:12:44
5QE3O8DLW7,Moran LLC,Till No,0.0,300.0,4521.93,Monday,2024-02-12 19:17:52
ZVKNPV7TXL,Edwards and Sons,Pay Bill,0.0,64.0,4821.93,Monday,2024-02-12 09:33:26
WDF1SQ2VU9,Miller-Gallagher,Till No,0.0,1350.0,4885.93,Sunday,2024-02-11 19:33:14
YWG55622Q3,Williams LLC,Till No,0.0,140.0,1235.93,Sunday,2024-02-11 16:50:36
ZXJNAVMB7J,Mpesa Charges,Mpesa Charges,0.0,26.6,1375.93,Saturday,2024-02-10 17:37:11
DDXBCBFHWB,Crawford Ltd,Till No,0.0,4838.0,1402.53,Saturday,2024-02-10 17:37:11
N9DJKJ4SW0,Mpesa Charges,Mpesa Charges,0.0,7.0,6240.53,Saturday,2024-02-10 17:30:15
GMMT0NN8KX,Christopher Castillo,Send Money,0.0,200.0,6247.53,Saturday,2024-02-10 17:30:15
3G4DI7Y7JR,"Jackson, Gutierrez and Bruce",Till No,0.0,190.0,7897.53,Friday,2024-02-09 17:15:10
WI8V5V7PNM,"Jackson, Gutierrez and Bruce",Till No,0.0,2878.0,8087.53,Friday,2024-02-09 17:13:51
WFY1KIWBK9,Gutierrez Inc,Bank Transfer,10000.0,0.0,10965.53,Friday,2024-02-09 17:03:44
IX0WUWPZ5V,Douglas Simon,Send Money,0.0,50.0,965.53,Friday,2024-02-09 16:52:50
AQB6A5DI0Q,Jordan-Roberson,Till No,0.0,663.0,1015.53,Friday,2024-02-09 10:39:14
V8VEI8PRCN,Jordan-Roberson,Till No,0.0,2568.0,1678.53,Friday,2024-02-09 10:36:16
YZV1QNRB7X,Mpesa Charges,Mpesa Charges,0.0,48.0,4246.53,Thursday,2024-02-08 21:16:04
A6Z687409M,Yates-Dunn,Pay Bill,0.0,9500.0,4294.53,Thursday,2024-02-08 21:16:04
FTK1X4XCPL,"Smith, Mcknight and Brown",Till No,0.0,40.0,13794.53,Thursday,2024-02-08 19:28:03
Z2B0NKLM5T,Michael Sanchez,Send Money,0.0,60.0,13834.53,Thursday,2024-02-08 19:24:51
XRHT2ZZK89,Moran LLC,Till No,0.0,250.0,13894.53,Thursday,2024-02-08 19:13:54
8IQTSS9KLH,Mpesa Charges,Mpesa Charges,0.0,57.0,14144.53,Thursday,2024-02-08 16:20:05
93Y68J492A,Roy Brown,Send Money,0.0,5000.0,14201.53,Thursday,2024-02-08 16:20:05
F2HNJPQW3J,Rebecca Hicks,Send Money,0.0,5000.0,14201.53,Thursday,2024-02-08 16:20:05
DZ5MN5NEW2,Mpesa Charges,Mpesa Charges,0.0,23.0,19201.53,Thursday,2024-02-08 16:10:37
GNB0YDJM7O,Deborah Terry,Send Money,0.0,1280.0,19224.53,Thursday,2024-02-08 16:10:37
4AHNWBV0N7,Diaz and Sons,Bank Transfer,20000.0,0.0,20504.53,Thursday,2024-02-08 16:08:22
Q2DP5K5Z7P,Mpesa Charges,Mpesa Charges,0.0,33.0,504.53,Wednesday,2024-02-07 14:47:53
P33LNB2NE8,Robert Cruz,Send Money,0.0,1995.0,537.53,Wednesday,2024-02-07 14:47:53
U34O4J3D57,"Carlson, Hanson and Martin",Till No,0.0,200.0,2532.53,Wednesday,2024-02-07 14:22:33
78Y1V51UN4,Shwari Withdraw,Mshwari Withdraw,1000.0,0.0,2732.53,Wednesday,2024-02-07 13:36:57
DX0OAJ4QDE,Shwari Loan Repayment From Savings,MShwari Loan,0.0,0.0,1732.53,Wednesday,2024-02-07 13:36:33
IK9HE7X1KJ,Mpesa Charges,Mpesa Charges,0.0,23.0,1732.53,Tuesday,2024-02-06 19:45:34
AXXN6WRR04,Javier Weaver,Send Money,0.0,1200.0,1755.53,Tuesday,2024-02-06 19:45:34
8F8I7T84DZ,Mpesa Charges,Mpesa Charges,0.0,33.0,2955.53,Tuesday,2024-02-06 13:05:56
Z1ANB90QFW,Payne and Sons,Till No,0.0,155.0,4978.53,Tuesday,2024-02-06 08:21:09
F5GC13EWSL,Lopez LLC,Till No,0.0,940.0,5133.53,Monday,2024-02-05 15:36:02
03YXJ42TH8,Mcmillan-Harmon,Bank Transfer,5000.0,0.0,6073.53,Monday,2024-02-05 15:00:15
46PE8LE678,Other,Other,0.0,1000.0,1073.53,Monday,2024-02-05 10:20:27
DL47Z2HL43,Mpesa Charges,Mpesa Charges,0.0,5.0,2073.53,Monday,2024-02-05 10:17:16
PBKCAW891T,White-Fowler,Pay Bill,0.0,500.0,2078.53,Monday,2024-02-05 10:17:16
77ANENEUVK,Mpesa Charges,Mpesa Charges,0.0,10.0,2578.53,Monday,2024-02-05 10:16:24
JL5LLKC9W7,White-Fowler,Pay Bill,0.0,700.0,2588.53,Monday,2024-02-05 10:16:24
M21SWDWIIJ,Mpesa Charges,Mpesa Charges,0.0,10.0,3288.53,Monday,2024-02-05 10:14:23
TKM01H3XWJ,White-Fowler,Pay Bill,0.0,800.0,3298.53,Monday,2024-02-05 10:14:23
TX2SDF5J2K,Mpesa Charges,Mpesa Charges,0.0,83.0,4098.53,Monday,2024-02-05 10:13:57
NR7FY9FN39,"Caldwell, King and Taylor",Pay Bill,0.0,31100.0,4181.53,Monday,2024-02-05 10:13:57
1TIPV2Y7TG,"Keith, Phillips and Singleton",Pay Bill,0.0,2999.0,35281.53,Monday,2024-02-05 08:46:06
TFZA9U6QX8,"Smith, Mcknight and Brown",Till No,0.0,45.0,38280.53,Sunday,2024-02-04 20:03:00
U2GGJZKTF4,Mpesa Charges,Mpesa Charges,0.0,7.0,38325.53,Sunday,2024-02-04 20:00:20
0BIIIC7IB7,Mpesa Charges,Mpesa Charges,0.0,33.0,38657.53,Saturday,2024-02-03 19:37:00
XP6SFZOGHC,Jeremy Kennedy,Send Money,0.0,2000.0,38690.53,Saturday,2024-02-03 19:37:00
IY7M66BJBJ,Mpesa Charges,Mpesa Charges,0.0,33.0,40690.53,Saturday,2024-02-03 14:06:10
QXPA0OX0OL,Joshua Cabrera,Send Money,0.0,2000.0,40723.53,Saturday,2024-02-03 14:06:10
K8Y8H56EV0,Stephanie Briggs,Send Money,0.0,100.0,42723.53,Saturday,2024-02-03 12:30:53
NUVN9T7QKN,"Carlson, Hanson and Martin",Till No,0.0,50.0,42823.53,Saturday,2024-02-03 12:29:42
VR5F6T942D,Mpesa Charges,Mpesa Charges,0.0,7.0,42873.53,Saturday,2024-02-03 11:24:53
1BG31GKXIU,Jason Lindsey,Send Money,0.0,360.0,42880.53,Saturday,2024-02-03 11:24:53
DWHOK38UYP,"Smith, Mcknight and Brown",Till No,0.0,90.0,43480.53,Friday,2024-02-02 20:16:21
J19G3E1B3L,"Perry, Leach and Mata",Till No,0.0,600.0,43570.53,Friday,2024-02-02 19:53:06
IOBMRT4LL1,Mpesa Charges,Mpesa Charges,0.0,13.0,44170.53,Friday,2024-02-02 19:51:18
ULCWLZCDZ6,David Allison,Send Money,0.0,1000.0,44183.53,Friday,2024-02-02 19:51:18
M6K7BHMKZZ,Chambers-Campbell,Bank Transfer,45000.0,0.0,45183.53,Friday,2024-02-02 19:50:51
DESD44V8DL,Hernandez LLC,Till No,0.0,1000.0,183.53,Friday,2024-02-02 19:32:27
5QZ04ZBE5F,Brown-Anderson,Till No,0.0,190.0,1183.53,Thursday,2024-02-01 19:11:27
E5U5ZFADJR,Mpesa Charges,Mpesa Charges,0.0,33.0,1373.53,Thursday,2024-02-01 19:03:39
FH0MNQ5P58,Brian Nguyen,Send Money,0.0,1995.0,1406.53,Thursday,2024-02-01 19:03:39
5GVCL9J7QK,Brown-Anderson,Till No,0.0,65.0,3401.53,Thursday,2024-02-01 09:20:31
6IH572W7JH,Lopez LLC,Till No,0.0,230.0,3466.53,Wednesday,2024-01-31 20:12:39
H838IWTRR1,Walker Inc,Till No,0.0,610.0,3696.53,Wednesday,2024-01-31 19:53:43
LKW7P65RDY,Brown-Anderson,Till No,0.0,50.0,4306.53,Wednesday,2024-01-31 16:15:10
KM9QWQOR4L,Griffith PLC,Till No,0.0,130.0,4356.53,Wednesday,2024-01-31 16:13:19
5EHV5BHN7N,Madison Pugh,Send Money,0.0,100.0,4486.53,Tuesday,2024-01-30 19:02:03
1L16BGJKD0,Griffith PLC,Till No,0.0,60.0,4586.53,Tuesday,2024-01-30 10:08:34
1TGLZJ3GKU,"Smith, Mcknight and Brown",Till No,0.0,50.0,4646.53,Monday,2024-01-29 18:35:51
OJ8JX40VK6,Benjamin Villanueva,Send Money,0.0,50.0,4696.53,Monday,2024-01-29 18:33:08
EOSZF1TMEI,Mpesa Charges,Mpesa Charges,0.0,7.0,4746.53,Monday,2024-01-29 18:30:12
6DL8FX102N,"Hill, Matthews and Martin",Till No,0.0,300.0,4943.53,Monday,2024-01-29 12:48:44
X0ZN14OJ6Y,Shwari Withdraw,Mshwari Withdraw,5000.0,0.0,5243.53,Monday,2024-01-29 12:48:18
JKPVSXZTRG,Wayne Porter,Pochi,0.0,70.0,243.53,Monday,2024-01-29 07:29:09
DJVWECJO0W,Mpesa Charges,Mpesa Charges,0.0,7.0,313.53,Sunday,2024-01-28 19:18:31
V50O518686,Chad Bradley,Send Money,0.0,500.0,320.53,Sunday,2024-01-28 19:18:31
8WY55NQEZ8,Mpesa Charges,Mpesa Charges,0.0,13.0,820.53,Saturday,2024-01-27 19:39:43
PQS0R93JHI,Katherine Mclaughlin,Send Money,0.0,780.0,833.53,Saturday,2024-01-27 19:39:43
OJCB3E5D5D,Mpesa Charges,Mpesa Charges,0.0,7.0,1613.53,Saturday,2024-01-27 19:04:28
UTH4OCOVO6,Jeffrey Smith,Send Money,0.0,170.0,1620.53,Saturday,2024-01-27 19:04:28
EWLDVED2VT,Mpesa Charges,Mpesa Charges,0.0,7.0,1790.53,Saturday,2024-01-27 19:01:26
KO2B0250R0,Madison Pugh,Send Money,0.0,400.0,1797.53,Saturday,2024-01-27 19:01:26
7MYGVTMSMR,Mpesa Charges,Mpesa Charges,0.0,5.0,2197.53,Saturday,2024-01-27 18:55:59
2DSBKW6M89,Yates-Dunn,Pay Bill,0.0,115.0,2202.53,Saturday,2024-01-27 18:55:59
JB2PZ626LS,Mpesa Charges,Mpesa Charges,0.0,5.0,2317.53,Saturday,2024-01-27 14:50:03
VRGMCAP7BZ,Yates-Dunn,Pay Bill,0.0,140.0,2322.53,Saturday,2024-01-27 14:50:03
FGB5CR2ALQ,"Franklin, Hatfield and Wilson",Till No,0.0,340.0,2462.53,Saturday,2024-01-27 14:42:14
R5XR8ZOHD5,Melinda Fields,Send Money,0.0,100.0,2802.53,Saturday,2024-01-27 13:46:53
M8LUKT4UXZ,"Franklin, Hatfield and Wilson",Till No,0.0,170.0,2902.53,Saturday,2024-01-27 10:32:55
LAULD6XL8A,Mpesa Charges,Mpesa Charges,0.0,23.0,3072.53,Saturday,2024-01-27 08:32:15
2KZ2CJDBMV,Joseph Perez,Send Money,0.0,1500.0,3095.53,Saturday,2024-01-27 08:32:15
MHH8MTOTMW,Dorothy Price,Send Money,0.0,1500.0,3095.53,Saturday,2024-01-27 08:32:15
A0NA7EOCAW,"Smith, Mcknight and Brown",Till No,0.0,60.0,4595.53,Friday,2024-01-26 20:24:50
WVT1QD6OOO,Alicia Chapman,Send Money,0.0,50.0,4655.53,Friday,2024-01-26 18:25:38
N21HQMWDV4,Mpesa Charges,Mpesa Charges,0.0,7.0,4705.53,Friday,2024-01-26 18:23:54
JU2ED1UDRJ,Nicholas Mitchell,Send Money,0.0,330.0,4712.53,Friday,2024-01-26 18:23:54
XQDRNI8H4M,Donald Cross,Send Money,0.0,100.0,5042.53,Friday,2024-01-26 17:18:29
ZX5VRPZGKP,Sullivan PLC,Till No,0.0,1900.0,5142.53,Friday,2024-01-26 16:41:02
XA2RG061JO,Shwari Withdraw,Mshwari Withdraw,5000.0,0.0,7042.53,Friday,2024-01-26 16:38:35
NZR79XZUAX,Griffin Group,Till No,0.0,1760.0,2042.53,Friday,2024-01-26 16:01:51
B09G4LVF2W,Michelle Brock,Pochi,0.0,40.0,3802.53,Friday,2024-01-26 15:28:03
H4BOE178DW,"Cummings, Baker and Rodriguez",Pay Bill,0.0,2070.0,3842.53,Friday,2024-01-26 14:26:05
VGZY417YH6,Shwari Withdraw,Mshwari Withdraw,5000.0,0.0,5912.53,Friday,2024-01-26 14:24:05
FTRARBV183,"Cummings, Baker and Rodriguez",Pay Bill,0.0,6200.0,912.53,Friday,2024-01-26 13:14:24
6SYU4AXSP1,Susan Davis,Send Money,0.0,100.0,7112.53,Friday,2024-01-26 12:38:40
TQPKWH1U97,Mpesa Charges,Mpesa Charges,0.0,10.0,7212.53,Friday,2024-01-26 10:34:08
OLXBVDCQKK,White-Fowler,Pay Bill,0.0,1000.0,7222.53,Friday,2024-01-26 10:34:08
B9PEY72G4L,Jennifer Hernandez,Send Money,0.0,50.0,8222.53,Thursday,2024-01-25 19:22:09
D5BUCL0JX0,Fisher Inc,Till No,0.0,90.0,8272.53,Thursday,2024-01-25 19:14:04
7GYTSKW4CO,"Franklin, Hatfield and Wilson",Till No,0.0,110.0,8362.53,Thursday,2024-01-25 19:10:49
HJ0EF3WSCU,"Franklin, Hatfield and Wilson",Till No,0.0,200.0,8472.53,Wednesday,2024-01-24 19:52:03
51K1N1L5ZV,Mpesa Charges,Mpesa Charges,0.0,7.0,8672.53,Wednesday,2024-01-24 09:03:28
L92LSUOXD3,Travis Escobar,Send Money,0.0,155.0,8679.53,Wednesday,2024-01-24 09:03:28
W7TI4E60RV,Shwari Deposit,Mshwari Deposit,0.0,20000.0,8834.53,Tuesday,2024-01-23 18:47:43
1KRYOLHZTG,"Smith, Mcknight and Brown",Till No,0.0,70.0,28834.53,Tuesday,2024-01-23 18:42:07
SW1D9GN5GF,Laurie Armstrong,Send Money,0.0,60.0,28904.53,Tuesday,2024-01-23 18:38:03
L614SKATCC,Mpesa Charges,Mpesa Charges,0.0,13.0,28964.53,Tuesday,2024-01-23 09:33:24
UUWDCSN6H7,Joseph Perez,Send Money,0.0,1000.0,28977.53,Tuesday,2024-01-23 09:33:24
7K1939U6IR,Dorothy Price,Send Money,0.0,1000.0,28977.53,Tuesday,2024-01-23 09:33:24
FJZKOYJ787,Griffith PLC,Till No,0.0,60.0,29977.53,Tuesday,2024-01-23 08:56:30
DPAT29YZYP, M-PESA Overdraw,Fuliza Loan Repayment,0.0,37.47,30037.53,Tuesday,2024-01-23 08:50:40
DD57BRSPGF,Roy Brown,Receive Money,30000.0,0.0,30075.0,Tuesday,2024-01-23 08:50:40
F7TZ8E33ZL,Rebecca Hicks,Receive Money,30000.0,0.0,30075.0,Tuesday,2024-01-23 08:50:40
0ERQ7ZSWEP,Mpesa Charges,Mpesa Charges,0.0,5.0,75.0,Monday,2024-01-22 22:30:52
LD2A2F0AZ0,"Lee, Beasley and Marshall",Pay Bill,0.0,100.0,230.0,Monday,2024-01-22 21:22:08
98ECKRY24K,Fuliza Loan,Fuliza Loan,37.09,0.0,330.0,Monday,2024-01-22 21:22:08
E0J8K4MTK0,Airtime Purchase,Airtime Purchase,0.0,20.0,292.91,Monday,2024-01-22 19:49:33
A316DEEWJ6,White-Fowler,Pay Bill,0.0,100.0,312.91,Monday,2024-01-22 18:34:06
6ZRPC2U9J4,Wagner Group,Bank Transfer,350.0,0.0,412.91,Monday,2024-01-22 18:33:17
W886DJWUC4,"Smith, Mcknight and Brown",Till No,0.0,20.0,62.91,Sunday,2024-01-21 16:56:51
I6ENNE3T4X,Laurie Armstrong,Send Money,0.0,60.0,82.91,Sunday,2024-01-21 16:54:24
XKOD7CC7K1,Mpesa Charges,Mpesa Charges,0.0,7.0,142.91,Sunday,2024-01-21 16:52:35
7QOE7JK0XD,Alicia Chapman,Send Money,0.0,110.0,149.91,Sunday,2024-01-21 16:52:35
UURERVC1XS,Mpesa Charges,Mpesa Charges,0.0,7.0,259.91,Sunday,2024-01-21 15:48:27
XG3ZB3JPA1,Nicholas Mitchell,Send Money,0.0,150.0,266.91,Sunday,2024-01-21 15:48:27
K94SICSOM2,Mpesa Charges,Mpesa Charges,0.0,7.0,416.91,Sunday,2024-01-21 15:46:24
IHKUZ1NOM4,Madison Pugh,Send Money,0.0,280.0,423.91,Sunday,2024-01-21 15:46:24
KWCK400E4W,Mpesa Charges,Mpesa Charges,0.0,13.0,703.91,Sunday,2024-01-21 15:43:03
0ZQS8KABQW,James Evans,Send Money,0.0,860.0,716.91,Sunday,2024-01-21 15:43:03
BS827FTU3F,Mpesa Charges,Mpesa Charges,0.0,13.0,1576.91,Sunday,2024-01-21 11:45:05
8IPTKAMWT7,Kayla Wells,Send Money,0.0,850.0,1589.91,Sunday,2024-01-21 11:45:05
CW5KYSI8KV,Lewis-Smith,Till No,0.0,150.0,2439.91,Sunday,2024-01-21 09:48:32
KLU2Y73UO5,Alicia Chapman,Send Money,0.0,30.0,2589.91,Friday,2024-01-19 18:41:54
M6D35BCLN0,Mr. Ryan Keith DVM,Send Money,0.0,40.0,2619.91,Friday,2024-01-19 18:40:24
WN5LLGD5WY,Mr. Ryan Keith DVM,Send Money,0.0,90.0,2659.91,Friday,2024-01-19 18:39:11
IBQ4E26MD3,Mpesa Charges,Mpesa Charges,0.0,7.0,2749.91,Friday,2024-01-19 18:36:23
6V7TPOVPZQ,Madison Pugh,Send Money,0.0,270.0,2756.91,Friday,2024-01-19 18:36:23
MEBX9WQM1U,Shwari Loan Request,MShwari Loan,0.0,0.0,3026.91,Friday,2024-01-19 18:30:34
Y83ZVL7QOG,Shwari Loan Disburse,MShwari Loan,3000.0,0.0,3026.91,Friday,2024-01-19 18:30:34
KGPMPAI66Z,"Smith, Mcknight and Brown",Till No,0.0,40.0,26.91,Thursday,2024-01-18 19:37:01
OBM47V7XOR,Mpesa Charges,Mpesa Charges,0.0,23.0,66.91,Thursday,2024-01-18 09:50:30
DR7KXIH1C8,Stephanie Butler,Send Money,0.0,1300.0,89.91,Thursday,2024-01-18 09:50:30
R4WCKO5B5X,Shwari Withdraw,Mshwari Withdraw,800.0,0.0,1389.91,Thursday,2024-01-18 09:49:27
JEE2JWCMAL,Mpesa Charges,Mpesa Charges,0.0,57.2,589.91,Thursday,2024-01-18 08:18:17
Z71MXPSK2Z,Klein Group,Till No,0.0,10400.0,647.11,Thursday,2024-01-18 08:18:17
BBPTPSSRQY,Allen-Clark,Bank Transfer,7500.0,0.0,11047.11,Thursday,2024-01-18 07:58:07
CLSC5VFA5Q,Mpesa Charges,Mpesa Charges,0.0,13.0,3547.11,Wednesday,2024-01-17 20:52:08
UUL2YX8HAZ,Stephanie Butler,Send Money,0.0,829.0,3560.11,Wednesday,2024-01-17 20:52:08
OXCE7MLIE2,Alicia Chapman,Send Money,0.0,60.0,4389.11,Wednesday,2024-01-17 20:07:14
9BZKCFB7DO,Mpesa Charges,Mpesa Charges,0.0,7.0,4449.11,Wednesday,2024-01-17 20:05:37
OKJJTRL0KO,Nicole Carrillo,Send Money,0.0,180.0,4456.11,Wednesday,2024-01-17 20:05:37
P5S7JZUVS7,Mpesa Charges,Mpesa Charges,0.0,13.0,4636.11,Wednesday,2024-01-17 19:19:31
IU82YWQG2C,David Allison,Send Money,0.0,1000.0,4649.11,Wednesday,2024-01-17 19:19:31
DDKPVG9YX1,Mpesa Charges,Mpesa Charges,0.0,10.0,5649.11,Wednesday,2024-01-17 17:08:37
B8V8FIPB72,"Bridges, Blackwell and Meyer",Pay Bill,0.0,800.0,5659.11,Wednesday,2024-01-17 17:08:37
74MOQDS16W,Mpesa Charges,Mpesa Charges,0.0,51.7,6459.11,Wednesday,2024-01-17 15:19:41
30FSYJT7I4,Phillips Ltd,Till No,0.0,9400.0,6510.81,Wednesday,2024-01-17 15:19:41
78AB9E9O23,Allen-Wolf,Bank Transfer,15000.0,0.0,15910.81,Wednesday,2024-01-17 15:18:24
XD9AIM9C1P,Mpesa Charges,Mpesa Charges,0.0,5.0,910.81,Wednesday,2024-01-17 08:45:40
NQDQ0A6ZV0,White-Fowler,Pay Bill,0.0,500.0,915.81,Wednesday,2024-01-17 08:45:40
XZPKF4T68L,Mpesa Charges,Mpesa Charges,0.0,53.0,1415.81,Tuesday,2024-01-16 18:48:07
KN6JWUAGKJ,Kristin Lloyd,Send Money,0.0,2570.0,1468.81,Tuesday,2024-01-16 18:48:07
B6MH8VXQ2W,Brown-Anderson,Till No,0.0,190.0,4038.81,Tuesday,2024-01-16 18:42:22
3AGKHJ5LEN,"Hill, Matthews and Martin",Till No,0.0,300.0,4228.81,Monday,2024-01-15 20:29:13
PBW7I01FCF,Mpesa Charges,Mpesa Charges,0.0,13.0,4528.81,Monday,2024-01-15 15:53:47
25OOGEWNZO,Stephanie Butler,Send Money,0.0,829.0,4541.81,Monday,2024-01-15 15:53:47
TVI25BJO73,Mpesa Charges,Mpesa Charges,0.0,7.0,5370.81,Monday,2024-01-15 15:52:40
2KCXSK8OA1,Adam Burns,Send Money,0.0,500.0,5377.81,Monday,2024-01-15 15:52:40
V4HBWHAF66,Mpesa Charges,Mpesa Charges,0.0,7.0,5877.81,Sunday,2024-01-14 15:46:04
6O7VL5O9ZJ,Nicholas Mitchell,Send Money,0.0,150.0,5884.81,Sunday,2024-01-14 15:46:04
72NE3PMJFT,Mpesa Charges,Mpesa Charges,0.0,7.0,6034.81,Sunday,2024-01-14 15:42:33
S7EZ5092M0,Madison Pugh,Send Money,0.0,240.0,6041.81,Sunday,2024-01-14 15:42:33
S3LPU6B4P3,Mpesa Charges,Mpesa Charges,0.0,42.0,6281.81,Sunday,2024-01-14 13:03:34
13OTDTDIXF,Adams-Ross,Pay Bill,0.0,6656.0,6323.81,Sunday,2024-01-14 13:03:34
E2ODGNG4GZ,Mpesa Charges,Mpesa Charges,0.0,7.0,12979.81,Sunday,2024-01-14 02:01:27
ILGNA4WJWC,Hector Kramer,Send Money,0.0,350.0,12986.81,Sunday,2024-01-14 02:01:27
YL425IVOKI,Theresa Kelly,Send Money,0.0,350.0,12986.81,Sunday,2024-01-14 02:01:27
169GQZTYQO,Todd Bradford,Send Money,0.0,100.0,13336.81,Saturday,2024-01-13 19:58:12
S0SOI2R4NR,Mpesa Charges,Mpesa Charges,0.0,53.0,13436.81,Saturday,2024-01-13 19:19:35
4H9IBM3FX5,Adam Burns,Send Money,0.0,3000.0,13489.81,Saturday,2024-01-13 19:19:35
VT667BEJAE,Mpesa Charges,Mpesa Charges,0.0,90.0,16489.81,Saturday,2024-01-13 16:26:33
HIND21JHZ8,Stephanie Butler,Send Money,0.0,8835.0,16579.81,Saturday,2024-01-13 16:26:33
H64YKB1XZC,Mpesa Charges,Mpesa Charges,0.0,53.0,25414.81,Saturday,2024-01-13 15:03:10
6C1ITBVLHV,Adam Burns,Send Money,0.0,3000.0,25467.81,Saturday,2024-01-13 15:03:10
IWQWPHOOFR,Kaitlyn Chavez,Send Money,0.0,100.0,28467.81,Saturday,2024-01-13 14:59:27
Q7A6J96684,Mpesa Charges,Mpesa Charges,0.0,57.0,28567.81,Saturday,2024-01-13 14:39:45
1JIMD2J5Z5,David Diaz,Send Money,0.0,4800.0,28624.81,Saturday,2024-01-13 14:39:45
Q3MIE4UW1F,Mpesa Charges,Mpesa Charges,0.0,29.0,33424.81,Saturday,2024-01-13 14:33:36
9OOC4XBUYD,"Anderson, Ferguson and Jones",Cash Withdrawal,0.0,1250.0,33453.81,Saturday,2024-01-13 14:33:36
06Y20A9DIY,Mpesa Charges,Mpesa Charges,0.0,197.0,34703.81,Saturday,2024-01-13 14:24:29
6TQFENQKTN,Lane Group,Cash Withdrawal,0.0,30400.0,34900.81,Saturday,2024-01-13 14:24:29
2MYA8TEK8T,Mpesa Charges,Mpesa Charges,0.0,69.0,65300.81,Saturday,2024-01-13 13:44:02
9BNH2ZOI92,"Anderson, Ferguson and Jones",Cash Withdrawal,0.0,3800.0,65369.81,Saturday,2024-01-13 13:44:02
VKQRDGHD10,Mpesa Charges,Mpesa Charges,0.0,13.0,69169.81,Saturday,2024-01-13 11:23:45
9S0966N5CL,Thomas Berry,Send Money,0.0,750.0,69182.81,Saturday,2024-01-13 11:23:45
338H8MX5B4,Other,Other,0.0,1000.0,69932.81,Saturday,2024-01-13 11:12:04
1DG6HMT9K6,Mpesa Charges,Mpesa Charges,0.0,5.0,70932.81,Saturday,2024-01-13 09:38:14
YYWXA2PSHS,Newman Inc,Pay Bill,0.0,155.0,70937.81,Saturday,2024-01-13 09:38:14
8PJM6KNXPF,Mpesa Charges,Mpesa Charges,0.0,5.0,71092.81,Saturday,2024-01-13 09:35:11
VG43MNRO78,Newman Inc,Pay Bill,0.0,120.0,71097.81,Saturday,2024-01-13 09:35:11
EQT26VFEZR,Mpesa Charges,Mpesa Charges,0.0,13.0,71217.81,Friday,2024-01-12 20:24:00
JA7QM0VEER,Amanda Baxter,Send Money,0.0,980.0,71230.81,Friday,2024-01-12 20:24:00
DCEE641VY7,Mpesa Charges,Mpesa Charges,0.0,108.0,72210.81,Friday,2024-01-12 19:36:45
96CDKRQZY8,Sarah Compton,Send Money,0.0,21500.0,72318.81,Friday,2024-01-12 19:36:45
GFVP8U6DUZ,Mpesa Charges,Mpesa Charges,0.0,11.0,93818.81,Friday,2024-01-12 19:32:01
JEK4YFRH5C,Brown PLC,Till No,0.0,2000.0,93829.81,Friday,2024-01-12 19:32:01
OC2ITHO2A5,Smith-Moore,Till No,0.0,1380.0,95829.81,Friday,2024-01-12 16:10:40
A0Q3FZJQB5,Mpesa Charges,Mpesa Charges,0.0,25.0,97209.81,Friday,2024-01-12 14:52:25
RGN4EA86D9,"Malone, Crawford and Shaw",Pay Bill,0.0,3245.0,97234.81,Friday,2024-01-12 14:52:25
0ND3X7TVEY,Mpesa Charges,Mpesa Charges,0.0,13.0,100479.81,Friday,2024-01-12 14:34:59
L1PPCFWKNM,Scott Wilkins,Send Money,0.0,960.0,100492.81,Friday,2024-01-12 14:34:59
YN157B4CUK,Gary Lynch,Receive Money,100000.0,0.0,101452.81,Friday,2024-01-12 14:17:38
GLO79XFBAU,Brittany Garrett,Receive Money,100000.0,0.0,101452.81,Friday,2024-01-12 14:17:38
VHSLWPZQRN,"Franklin, Hatfield and Wilson",Till No,0.0,390.0,1452.81,Thursday,2024-01-11 19:12:48
9Y5XA0B53M,Mpesa Charges,Mpesa Charges,0.0,23.0,1842.81,Thursday,2024-01-11 18:03:36
H5S4ZDXTX8,Glenn Gonzalez,Send Money,0.0,1200.0,1865.81,Thursday,2024-01-11 18:03:36
B8U3MIN8NM,Mpesa Charges,Mpesa Charges,0.0,23.0,3065.81,Thursday,2024-01-11 16:54:18
GVKCW50R0H,Rachel Klein,Send Money,0.0,1500.0,3088.81,Thursday,2024-01-11 16:54:18
KEMTU06BQ0,Mpesa Charges,Mpesa Charges,0.0,13.0,4588.81,Thursday,2024-01-11 14:39:47
DXW4D1HI4D,John Russo,Send Money,0.0,960.0,4601.81,Thursday,2024-01-11 14:39:47
1MJI3U59MT,Marshall-Green,Bank Transfer,5000.0,0.0,5561.81,Thursday,2024-01-11 13:38:34
Z7KC7223IU,Mpesa Charges,Mpesa Charges,0.0,7.0,561.81,Wednesday,2024-01-10 14:59:57
CHZ2AO9EQL,Bradley Evans,Send Money,0.0,450.0,568.81,Wednesday,2024-01-10 14:59:57
AMJOSHFQV5,Mpesa Charges,Mpesa Charges,0.0,53.0,1018.81,Wednesday,2024-01-10 12:59:31
0OTZWOYEDW,Cindy Romero,Send Money,0.0,3058.0,1071.81,Wednesday,2024-01-10 12:59:31
D14JOP1710,Newman Inc,Pay Bill,0.0,65.0,4129.81,Wednesday,2024-01-10 10:05:43
ZZVJNQSDDD,Mpesa Charges,Mpesa Charges,0.0,5.0,4194.81,Tuesday,2024-01-09 08:30:31
IJLM9216YB,White-Fowler,Pay Bill,0.0,500.0,4199.81,Tuesday,2024-01-09 08:30:31
PBMXI0GZ9E,"Smith, Mcknight and Brown",Till No,0.0,60.0,4699.81,Monday,2024-01-08 19:31:49
2WWDBZX0T7,Mpesa Charges,Mpesa Charges,0.0,15.0,4759.81,Monday,2024-01-08 17:57:51
OLFBB40MGT,Morales PLC,Pay Bill,0.0,1044.0,4774.81,Monday,2024-01-08 17:57:51
RMPE5PY9QI,Mpesa Charges,Mpesa Charges,0.0,13.0,5818.81,Sunday,2024-01-07 21:43:48
YSFHLYNK2U,Joseph Perez,Send Money,0.0,750.0,5831.81,Sunday,2024-01-07 21:43:48
FWEHX9R7XE,Dorothy Price,Send Money,0.0,750.0,5831.81,Sunday,2024-01-07 21:43:48
VZDE6RW9PF,"Smith, Mcknight and Brown",Till No,0.0,30.0,6581.81,Sunday,2024-01-07 18:54:43
3QAAAN6I3N,Mpesa Charges,Mpesa Charges,0.0,7.0,6788.81,Sunday,2024-01-07 14:10:53
15D7J13K23,Sandra Murray,Send Money,0.0,400.0,6795.81,Sunday,2024-01-07 14:10:53
6TX82YOZC8,Mpesa Charges,Mpesa Charges,0.0,5.0,7195.81,Sunday,2024-01-07 10:54:01
Q041G64CFG,Newman Inc,Pay Bill,0.0,155.0,7200.81,Sunday,2024-01-07 10:54:01
HEJF693DC0,Mpesa Charges,Mpesa Charges,0.0,7.0,7355.81,Saturday,2024-01-06 20:07:03
K67U3GANVF,John Roberson,Send Money,0.0,155.0,7362.81,Saturday,2024-01-06 20:07:03
QWNJVL7WVL,Wells-Day,Till No,0.0,300.0,7517.81,Saturday,2024-01-06 20:03:00
UXSCXVX3UF,Brown-Anderson,Till No,0.0,1200.0,7817.81,Saturday,2024-01-06 19:49:05
R6YU15LB6G,"Smith, Mcknight and Brown",Till No,0.0,110.0,9017.81,Saturday,2024-01-06 19:46:45
7BKTUTVEMX,"Smith, Mcknight and Brown",Till No,0.0,50.0,9127.81,Friday,2024-01-05 20:35:19
MZKHYZ3H96,"Keith, Phillips and Singleton",Pay Bill,0.0,2999.0,9177.81,Friday,2024-01-05 17:33:32
231BP29A11,Mpesa Charges,Mpesa Charges,0.0,83.0,12176.81,Friday,2024-01-05 17:22:39
XXNRZ7FT8G,"Caldwell, King and Taylor",Pay Bill,0.0,31100.0,12259.81,Friday,2024-01-05 17:22:39
NPOE5TN7L3,Mpesa Charges,Mpesa Charges,0.0,7.0,43359.81,Friday,2024-01-05 16:44:32
VO9BPOWPDJ,Patrick Mcconnell,Send Money,0.0,500.0,43366.81,Friday,2024-01-05 16:44:32
3IWQ40ZIV3,Lee Ltd,Pay Bill,0.0,20.0,43866.81,Friday,2024-01-05 12:43:38
M55EDJSOF9,Mpesa Charges,Mpesa Charges,0.0,33.0,43886.81,Friday,2024-01-05 09:53:38
9237GWCRB9,Guerra and Sons,Bank Transfer,45000.0,0.0,45919.81,Friday,2024-01-05 09:48:36
0IVBDYA4JK,Mpesa Charges,Mpesa Charges,0.0,10.0,919.81,Thursday,2024-01-04 18:59:44
S2DDNQJKA5,Beck-Buck,Pay Bill,0.0,650.0,929.81,Thursday,2024-01-04 18:59:44
XSQLW35PY1,Airtime Purchase,Airtime Purchase,0.0,50.0,1579.81,Sunday,2023-12-31 20:48:01
51QT643PLZ,Other,Other,0.0,1000.0,1629.81,Saturday,2023-12-30 08:52:49
FZ7KDP50AB,Airtime Purchase,Airtime Purchase,0.0,50.0,2629.81,Friday,2023-12-29 23:05:43
ZEU5VY9KZT,Navarro and Sons,Bank Transfer,2500.0,0.0,2679.81,Friday,2023-12-29 18:56:38
KGZXWFS2G4,Airtime Purchase,Airtime Purchase,0.0,50.0,179.81,Friday,2023-12-29 18:55:11
COX53X0Q17,Airtime Purchase,Airtime Purchase,0.0,50.0,229.81,Friday,2023-12-29 12:08:30
S64WA5MYK9,Airtime Purchase,Airtime Purchase,0.0,50.0,279.81,Thursday,2023-12-28 14:56:20
3PKCT5QG48,Airtime Purchase,Airtime Purchase,0.0,50.0,329.81,Thursday,2023-12-28 12:08:32
TFWIJ48102,Airtime Purchase,Airtime Purchase,0.0,20.0,379.81,Tuesday,2023-12-26 21:30:15
7TVTI4FIKB,Mpesa Charges,Mpesa Charges,0.0,7.0,399.81,Monday,2023-12-25 12:54:59
LFP89VIWSW,Gary Lynch,Send Money,0.0,300.0,406.81,Monday,2023-12-25 12:54:59
1I65XS3REM,Brittany Garrett,Send Money,0.0,300.0,406.81,Monday,2023-12-25 12:54:59
S30DZB65WY,Walters and Sons,Pay Bill,0.0,50.0,706.81,Saturday,2023-12-23 20:03:09
WDZDSZXMKL,"Schmitt, Mullins and Collins",Till No,0.0,20.0,756.81,Friday,2023-12-22 07:52:15
FUKU4RA0P9,Mpesa Charges,Mpesa Charges,0.0,5.0,776.81,Friday,2023-12-22 03:57:33
2AY48WKX7F,White-Fowler,Pay Bill,0.0,300.0,781.81,Friday,2023-12-22 03:57:33
MMX7OKK9DO,Brown-Anderson,Till No,0.0,190.0,1081.81,Thursday,2023-12-21 20:17:43
PF0G4O1WB1,Mpesa Charges,Mpesa Charges,0.0,53.0,1271.81,Thursday,2023-12-21 20:15:30
JHTXEJOIIQ,Susan Smith,Send Money,0.0,2668.0,1324.81,Thursday,2023-12-21 20:15:30
PZS5GF5D56,Mpesa Charges,Mpesa Charges,0.0,3.49,4092.81,Thursday,2023-12-21 15:49:29
4AMF9LOW3B,"Vega, Levine and Benjamin",Till No,0.0,1812.0,4741.26,Thursday,2023-12-21 15:29:11
YIQNZFMIWI,Brown-Anderson,Till No,0.0,160.0,6553.26,Thursday,2023-12-21 08:23:27
LLKRODAQZR,Michael Sanchez,Send Money,0.0,60.0,6713.26,Wednesday,2023-12-20 18:31:20
7T92U05Q8B,Lopez LLC,Till No,0.0,850.0,6773.26,Wednesday,2023-12-20 18:26:39
WEE2OWWWIS,Newman Inc,Pay Bill,0.0,65.0,7623.26,Wednesday,2023-12-20 09:37:06
IISXR5J1OQ,Mpesa Charges,Mpesa Charges,0.0,5.0,7688.26,Tuesday,2023-12-19 20:26:51
5JD8DW38BF,White-Fowler,Pay Bill,0.0,500.0,7693.26,Tuesday,2023-12-19 20:26:51
4Z1P0GBFN8,"Smith, Mcknight and Brown",Till No,0.0,235.0,8193.26,Tuesday,2023-12-19 19:35:32
8OUI4QJO1E,"Hill, Matthews and Martin",Till No,0.0,300.0,8428.26,Tuesday,2023-12-19 16:53:30
SK98AQOD4F,Mpesa Charges,Mpesa Charges,0.0,13.0,8728.26,Tuesday,2023-12-19 13:20:50
OUUP5F5XBW,Thomas Edwards,Send Money,0.0,1000.0,8741.26,Tuesday,2023-12-19 13:20:50
GCFU81UKCH,Mpesa Charges,Mpesa Charges,0.0,108.0,9741.26,Tuesday,2023-12-19 13:17:59
4VJAIGKVQE,Jared Moore,Send Money,0.0,30000.0,9849.26,Tuesday,2023-12-19 13:17:59
XAVI8C1RJR,Stacey Fletcher,Receive Money,35000.0,0.0,39849.26,Tuesday,2023-12-19 13:16:00
LBN5REC5IW,Mpesa Charges,Mpesa Charges,0.0,33.0,4849.26,Tuesday,2023-12-19 13:02:19
1OV8CTUMRG,Kristina Deleon,Send Money,0.0,1600.0,4882.26,Tuesday,2023-12-19 13:02:19
NN0JDPWNQH,Wiggins-Morales,Bank Transfer,5000.0,0.0,6482.26,Tuesday,2023-12-19 13:01:16
297XIFRHTZ,Mpesa Charges,Mpesa Charges,0.0,5.0,1482.26,Tuesday,2023-12-19 10:34:46
NFRZCMZP70,Hernandez-Lewis,Pay Bill,0.0,300.0,1487.26,Tuesday,2023-12-19 10:34:46
XRGKVZL9MV,Mpesa Charges,Mpesa Charges,0.0,13.0,1787.26,Monday,2023-12-18 19:57:38
Q2TKD69L95,David Allison,Send Money,0.0,1000.0,1800.26,Monday,2023-12-18 19:57:38
M4F47ZYGTS,Deanna Martinez,Pochi,0.0,70.0,2800.26,Monday,2023-12-18 08:23:38
J7UK6RCPJB,Tim Thomas,Pochi,0.0,30.0,2870.26,Monday,2023-12-18 08:05:11
EXXD2CEGMN,Buck Group,Till No,0.0,1490.0,2900.26,Sunday,2023-12-17 21:15:14
IFC85148XZ,Mpesa Charges,Mpesa Charges,0.0,13.0,4390.26,Sunday,2023-12-17 20:05:16
E0VWAIMU1G,Mrs. Michelle Marshall,Send Money,0.0,900.0,4403.26,Sunday,2023-12-17 20:05:16
QN1E9ALQF2,"Soto, Carlson and Gomez",Bank Transfer,5000.0,0.0,5303.26,Sunday,2023-12-17 19:49:55
FYOX9S4LJD,Yates-Dunn,Pay Bill,0.0,70.0,303.26,Sunday,2023-12-17 15:01:43
ZT4ADZG8UD,Mpesa Charges,Mpesa Charges,0.0,5.0,373.26,Sunday,2023-12-17 14:58:31
8D0SKR9VF7,Potts-Waller,Pay Bill,0.0,120.0,378.26,Sunday,2023-12-17 14:58:31
EQNW6SADJE,Mpesa Charges,Mpesa Charges,0.0,7.0,498.26,Sunday,2023-12-17 12:29:21
C1NQLTYOIM,Hector Kramer,Send Money,0.0,150.0,505.26,Sunday,2023-12-17 12:29:21
H14U1T5O7I,Theresa Kelly,Send Money,0.0,150.0,505.26,Sunday,2023-12-17 12:29:21
EHYYGBRPPS,"Smith, Mcknight and Brown",Till No,0.0,60.0,655.26,Saturday,2023-12-16 21:00:55
AAMBAJD908,Mpesa Charges,Mpesa Charges,0.0,20.0,715.26,Saturday,2023-12-16 19:08:18
1LF1KVEG4M,"Bridges, Blackwell and Meyer",Pay Bill,0.0,1700.0,735.26,Saturday,2023-12-16 19:08:18
WL2ELXBTQX,Roy Brown,Receive Money,700.0,0.0,2435.26,Saturday,2023-12-16 18:59:04
CMZXBOVFU6,Rebecca Hicks,Receive Money,700.0,0.0,2435.26,Saturday,2023-12-16 18:59:04
BBI7L58IFV,Mpesa Charges,Mpesa Charges,0.0,7.0,1735.26,Saturday,2023-12-16 16:45:42
JB5HC8JSVO,Angela Cook,Send Money,0.0,400.0,1742.26,Saturday,2023-12-16 16:45:42
T6NIA8S1B4,Mpesa Charges,Mpesa Charges,0.0,15.0,2142.26,Saturday,2023-12-16 16:24:40
BIS8IQHC5M,Yates-Dunn,Pay Bill,0.0,1400.0,2157.26,Saturday,2023-12-16 16:24:40
RKMP805HVX,Fisher Inc,Till No,0.0,280.0,3557.26,Saturday,2023-12-16 09:14:22
CEBZTAR1RO,"Franklin, Hatfield and Wilson",Till No,0.0,450.0,3837.26,Friday,2023-12-15 19:42:41
L57G3XFQRB,Laurie Armstrong,Send Money,0.0,50.0,4287.26,Thursday,2023-12-14 19:33:55
7O7SG704BI,"Franklin, Hatfield and Wilson",Till No,0.0,440.0,4337.26,Thursday,2023-12-14 19:27:04
QVSHV7UAVX,Fisher Inc,Till No,0.0,220.0,4777.26,Thursday,2023-12-14 09:17:32
X37Y1UBNWP,"Smith, Mcknight and Brown",Till No,0.0,70.0,4997.26,Wednesday,2023-12-13 19:20:07
RAOTU97W7A,"Dillon, Wolf and Barnes",Bank Transfer,5000.0,0.0,5067.26,Wednesday,2023-12-13 19:19:51
AFR7VJ76JE,Mpesa Charges,Mpesa Charges,0.0,13.0,67.26,Wednesday,2023-12-13 14:34:27
YUBNKX92GU,Mpesa Charges,Mpesa Charges,0.0,13.0,940.26,Wednesday,2023-12-13 11:20:30
OMMDY5W6T1,Christy Gregory,Send Money,0.0,760.0,953.26,Wednesday,2023-12-13 11:20:30
H7FOIHI1B2,"Wilson, Wilson and Horton",Till No,0.0,60.0,1713.26,Wednesday,2023-12-13 11:17:50
RFO37I03BB,Mpesa Charges,Mpesa Charges,0.0,13.0,1773.26,Wednesday,2023-12-13 08:41:07
DITPENGIS7,Caleb Obrien,Send Money,0.0,540.0,1786.26,Wednesday,2023-12-13 08:41:07
FVTQA8LNCS,Mpesa Charges,Mpesa Charges,0.0,5.0,2326.26,Tuesday,2023-12-12 22:15:11
ESQG7H7EFB,White-Fowler,Pay Bill,0.0,500.0,2331.26,Tuesday,2023-12-12 22:15:11
FPFYD92C3B,Brown-Anderson,Till No,0.0,160.0,2831.26,Tuesday,2023-12-12 19:31:53
DYR3CZNH5W,"Smith, Mcknight and Brown",Till No,0.0,120.0,2991.26,Tuesday,2023-12-12 19:30:41
RUYBXEBU1A,Lisa Bradley,Send Money,0.0,100.0,3111.26,Tuesday,2023-12-12 18:39:04
MCFGI3OLD9,Mpesa Charges,Mpesa Charges,0.0,20.0,3211.26,Tuesday,2023-12-12 18:02:37
FS60L3ZK78,Patel PLC,Pay Bill,0.0,2224.0,3231.26,Tuesday,2023-12-12 18:02:37
4751P45VMA,Williams-Hunt,Bank Transfer,5000.0,0.0,5455.26,Tuesday,2023-12-12 18:01:27
8BYKP8CSMD,Mpesa Charges,Mpesa Charges,0.0,33.0,455.26,Monday,2023-12-11 19:24:58
NAHQSX7FQ1,Susan Smith,Send Money,0.0,1748.0,488.26,Monday,2023-12-11 19:24:58
CINF360UEO,Mpesa Charges,Mpesa Charges,0.0,20.0,2236.26,Sunday,2023-12-10 21:40:51
K6DFBYVE7B,"Benitez, Palmer and Lane",Pay Bill,0.0,2334.0,2256.26,Sunday,2023-12-10 21:40:51
285LHMZC4O,"Carlson, Hanson and Martin",Till No,0.0,200.0,4590.26,Sunday,2023-12-10 21:25:23
89HCW7RZHW,Hernandez LLC,Till No,0.0,500.0,4790.26,Sunday,2023-12-10 18:07:44
YJ4G8SV8AO,"Santos, Hicks and Shaw",Bank Transfer,5000.0,0.0,5290.26,Sunday,2023-12-10 18:06:57
LAZJ75LQRA,Mpesa Charges,Mpesa Charges,0.0,25.0,290.26,Sunday,2023-12-10 15:01:32
3KIGE3ZK5A,Williams and Sons,Pay Bill,0.0,3113.0,315.26,Sunday,2023-12-10 15:01:32
XNU5I5XEFE,Mpesa Charges,Mpesa Charges,0.0,7.0,3428.26,Saturday,2023-12-09 20:13:08
TN6RB0ON6J,Alicia Chapman,Send Money,0.0,150.0,3435.26,Saturday,2023-12-09 20:13:08
8CGZ3VSDTI,Mpesa Charges,Mpesa Charges,0.0,7.0,3585.26,Saturday,2023-12-09 20:11:39
C7UISDVUI4,Kevin Strong,Send Money,0.0,150.0,3592.26,Saturday,2023-12-09 20:11:39
H6FHH61KF6,"Hill, Matthews and Martin",Till No,0.0,300.0,3742.26,Saturday,2023-12-09 13:24:00
8Z0BDHWPW8,Mpesa Charges,Mpesa Charges,0.0,7.0,4042.26,Saturday,2023-12-09 12:20:27
082QOSI30H,Jason Lindsey,Send Money,0.0,330.0,4049.26,Saturday,2023-12-09 12:20:27
D7A7A6H7ZV,"Smith, Mcknight and Brown",Till No,0.0,155.0,4379.26,Friday,2023-12-08 20:20:02
KK6TDA7YK0,"Gomez, Rice and Simpson",Till No,0.0,1631.0,4534.26,Friday,2023-12-08 18:46:41
1BAD6QJTTT,"Paul, Williams and Brown",Bank Transfer,5000.0,0.0,6165.26,Friday,2023-12-08 18:36:19
OAKPNKWTAJ,Mpesa Charges,Mpesa Charges,0.0,20.0,1165.26,Friday,2023-12-08 18:27:45
KSRDBGQM1O,"Bridges, Blackwell and Meyer",Pay Bill,0.0,2000.0,1185.26,Friday,2023-12-08 18:27:45
FWT64RXELJ,Daniel Ingram,Send Money,0.0,100.0,3185.26,Friday,2023-12-08 16:34:12
QEHBUYN6LN,Moran LLC,Till No,0.0,250.0,3285.26,Friday,2023-12-08 16:33:20
J75R8SJ68J,Griffith PLC,Till No,0.0,150.0,3535.26,Friday,2023-12-08 15:28:07
8QTZKGXKTX,Mpesa Charges,Mpesa Charges,0.0,7.0,3685.26,Friday,2023-12-08 12:57:46
5NQ5KOMG0P,Stephanie Reyes,Send Money,0.0,150.0,3692.26,Friday,2023-12-08 12:57:46
6KTIDU837P,Joseph Perez,Receive Money,1286.0,0.0,3842.26,Thursday,2023-12-07 18:25:57
FR6FAGHHSV,Dorothy Price,Receive Money,1286.0,0.0,3842.26,Thursday,2023-12-07 18:25:57
FU8BL7R4CC,Mpesa Charges,Mpesa Charges,0.0,15.0,2556.26,Thursday,2023-12-07 17:47:33
ICSGRW6SOA,Moreno-Hernandez,Pay Bill,0.0,1287.0,2571.26,Thursday,2023-12-07 17:47:33
UBWJW0VCWF,Lewis-Smith,Till No,0.0,65.0,3858.26,Thursday,2023-12-07 07:43:49
5E5UJOT2IW,Mpesa Charges,Mpesa Charges,0.0,13.0,3923.26,Wednesday,2023-12-06 19:18:02
IXVXB97LSN,Chad Bradley,Send Money,0.0,600.0,3936.26,Wednesday,2023-12-06 19:18:02
PWIW2W4M7G,Mpesa Charges,Mpesa Charges,0.0,53.0,4536.26,Tuesday,2023-12-05 18:53:38
5Z2GPK37GQ,Heather Eaton,Send Money,0.0,2688.0,4589.26,Tuesday,2023-12-05 18:53:38
RINMMNR6JF,Mpesa Charges,Mpesa Charges,0.0,33.0,7277.26,Tuesday,2023-12-05 13:22:38
2D5EJS95XE,Melissa Nichols,Send Money,0.0,1694.0,7310.26,Tuesday,2023-12-05 13:22:38
CTRJU01VCS,Mpesa Charges,Mpesa Charges,0.0,7.0,9004.26,Monday,2023-12-04 19:11:00
95FNNKLMX6,Alicia Chapman,Send Money,0.0,120.0,9011.26,Monday,2023-12-04 19:11:00
6HUUA2U6RZ,Mpesa Charges,Mpesa Charges,0.0,83.0,9131.26,Monday,2023-12-04 17:09:36
9USTYLGF0G,"Caldwell, King and Taylor",Pay Bill,0.0,31300.0,9214.26,Monday,2023-12-04 17:09:36
I11X0TWMT7,Mpesa Charges,Mpesa Charges,0.0,72.0,40514.26,Monday,2023-12-04 08:37:52
B99MU6U62L,"Salinas, Evans and Hester",Pay Bill,0.0,30000.0,40586.26,Monday,2023-12-04 08:37:52
22OKLO73KC,"Hunt, Barnes and Castillo",Bank Transfer,70000.0,0.0,70586.26,Monday,2023-12-04 08:35:36
AUEZLL8H0J,Mpesa Charges,Mpesa Charges,0.0,5.0,586.26,Monday,2023-12-04 08:31:11
8GAEIRQ6SS,White-Fowler,Pay Bill,0.0,500.0,591.26,Monday,2023-12-04 08:31:11
KUH4I8W0Z7,Payne and Sons,Till No,0.0,70.0,1091.26,Monday,2023-12-04 08:23:22
VYAB15X4I8,Fisher Inc,Till No,0.0,160.0,1161.26,Monday,2023-12-04 08:19:33
UFJJBGA65I,Mark Pope,Pochi,0.0,80.0,1321.26,Monday,2023-12-04 07:39:40
VVRPAV3Q28,Jeremy Boyle,Pochi,0.0,30.0,1401.26,Monday,2023-12-04 07:24:34
FVUGJW462Q,Buck Group,Till No,0.0,900.0,1431.26,Sunday,2023-12-03 17:54:15
JN7FUMLGY7,Mpesa Charges,Mpesa Charges,0.0,13.0,2331.26,Sunday,2023-12-03 16:02:07
D0R865S5MS,Michael Hayes,Send Money,0.0,920.0,2344.26,Sunday,2023-12-03 16:02:07
BTKXV1YH55,Peters-Reyes,Till No,0.0,200.0,3264.26,Sunday,2023-12-03 14:42:03
EE0LIAVIO1,Mpesa Charges,Mpesa Charges,0.0,13.0,3464.26,Sunday,2023-12-03 13:39:47
025N3OQLT9,Ryan Wilson,Send Money,0.0,730.0,3477.26,Sunday,2023-12-03 13:39:47
07QO55ZQB7,Jeremy Kennedy,Send Money,0.0,5000.0,4264.26,Sunday,2023-12-03 10:17:02
AAIZ2P6CWT,Thompson-Saunders,Till No,0.0,365.0,4264.26,Saturday,2023-12-02 19:04:19
N61A9A2KRC,Mpesa Charges,Mpesa Charges,0.0,5.0,4629.26,Saturday,2023-12-02 19:00:28
8WUU7DKXMX,Palmer PLC,Pay Bill,0.0,190.0,4634.26,Saturday,2023-12-02 19:00:28
SECLFZCFG7,Mpesa Charges,Mpesa Charges,0.0,7.0,4824.26,Saturday,2023-12-02 13:29:53
LGK0SN68P8,Jason Lindsey,Send Money,0.0,330.0,4831.26,Saturday,2023-12-02 13:29:53
NV6NLM1JZL,Mr. Bryan Robinson,Send Money,0.0,50.0,5161.26,Saturday,2023-12-02 12:41:37
EF6S2C37RS,Mpesa Charges,Mpesa Charges,0.0,23.0,5211.26,Friday,2023-12-01 21:42:33
BAGER1SQD4,Eric Duran,Send Money,0.0,1080.0,5234.26,Friday,2023-12-01 21:42:33
SHMPA1D8RP,"Hill, Matthews and Martin",Till No,0.0,300.0,6314.26,Friday,2023-12-01 10:16:46
K3SM3I0XDE,Mpesa Charges,Mpesa Charges,0.0,13.0,613.26,Thursday,2023-11-30 20:16:37
T44U45TNEA,Kimberly Austin,Send Money,0.0,983.0,626.26,Thursday,2023-11-30 20:16:37
81LL9245Z5,"Carlson, Hanson and Martin",Till No,0.0,65.0,1609.26,Thursday,2023-11-30 18:43:00
R1XTEEPA1Z,"Franklin, Hatfield and Wilson",Till No,0.0,330.0,1674.26,Thursday,2023-11-30 18:34:39
6W35BIQ093,"Lewis, Bright and Gallagher",Till No,0.0,4200.0,2004.26,Thursday,2023-11-30 14:41:03
BPV6Y18CST,Griffith PLC,Till No,0.0,110.0,6204.26,Thursday,2023-11-30 08:47:45
LSM6QX09EW,"Smith, Mcknight and Brown",Till No,0.0,80.0,6314.26,Tuesday,2023-11-28 20:04:31
EGCNOVGZI9,David Allison,Send Money,0.0,100.0,6394.26,Monday,2023-11-27 21:31:28
7I3FL0I9T7,Mpesa Charges,Mpesa Charges,0.0,23.0,6494.26,Monday,2023-11-27 20:58:43
BSPYEO5ICE,David Allison,Send Money,0.0,1100.0,6517.26,Monday,2023-11-27 20:58:43
7F5X5I9T4F,Mpesa Charges,Mpesa Charges,0.0,5.0,7617.26,Sunday,2023-11-26 23:27:14
X0Z3HA0F4T,White-Fowler,Pay Bill,0.0,500.0,7622.26,Sunday,2023-11-26 23:27:14
E2810HYOW4,Mpesa Charges,Mpesa Charges,0.0,13.0,8122.26,Sunday,2023-11-26 23:24:23
BF8FPDCBDD,Jeremy Kennedy,Send Money,0.0,1000.0,8135.26,Sunday,2023-11-26 23:24:23
C7386UE7W3,Kelsey Potter,Receive Money,6000.0,0.0,9135.26,Sunday,2023-11-26 06:50:51
63PDU7JN7G,Charlotte Davis,Receive Money,6000.0,0.0,9135.26,Sunday,2023-11-26 06:50:51
9LMPWR9DPH,Mpesa Charges,Mpesa Charges,0.0,13.0,3135.26,Saturday,2023-11-25 22:28:29
VBHTQIO6MA,Jose King,Send Money,0.0,650.0,3148.26,Saturday,2023-11-25 22:28:29
GQED6D4KFE,Mpesa Charges,Mpesa Charges,0.0,13.0,3798.26,Saturday,2023-11-25 18:31:56
MTTV2QJ42Z,Laura Fletcher,Send Money,0.0,1000.0,3811.26,Saturday,2023-11-25 18:31:56
IS6UPATTG7,"Smith, Mcknight and Brown",Till No,0.0,190.0,4811.26,Saturday,2023-11-25 18:27:27
8ZBXPBRY7L,"Matthews, Boyle and Erickson",Bank Transfer,5000.0,0.0,5001.26,Saturday,2023-11-25 18:26:34
M25PQ9UERC,Daniel Ellis,Send Money,0.0,100.0,1.26,Friday,2023-11-24 18:55:03
3UEB22WVN6,Mpesa Charges,Mpesa Charges,0.0,7.0,101.26,Friday,2023-11-24 18:53:19
5QOI8FGVBX,Madison Pugh,Send Money,0.0,150.0,108.26,Friday,2023-11-24 18:53:19
TZ9EHW4OQ6,Mpesa Charges,Mpesa Charges,0.0,13.75,258.26,Friday,2023-11-24 18:22:38
HIVYA650HA,Wallace PLC,Till No,0.0,2500.0,272.01,Friday,2023-11-24 18:22:38
IJVFEAKIK9,Ochoa LLC,Till No,0.0,65.0,2772.01,Friday,2023-11-24 08:20:31
PILHSWYM14,"Ho, Howell and Welch",Till No,0.0,260.0,2837.01,Thursday,2023-11-23 19:49:45
CNMH3S6GH5,"Carlson, Hanson and Martin",Till No,0.0,65.0,3097.01,Thursday,2023-11-23 10:19:32
KRVU72U15G,Mpesa Charges,Mpesa Charges,0.0,23.0,3162.01,Wednesday,2023-11-22 16:34:13
3MKT2NWOPF,Kristin Lloyd,Send Money,0.0,1476.0,3185.01,Wednesday,2023-11-22 16:34:13
G0VLEHQBDA,Lopez LLC,Till No,0.0,810.0,4661.01,Tuesday,2023-11-21 20:15:53
SZ476O6TR8,Hernandez-Robertson,Bank Transfer,5000.0,0.0,5471.01,Tuesday,2023-11-21 20:13:15
S212HO6ZUB,"Franklin, Hatfield and Wilson",Till No,0.0,200.0,471.01,Tuesday,2023-11-21 14:55:00
0F6D76H2CA,Mpesa Charges,Mpesa Charges,0.0,53.0,671.01,Tuesday,2023-11-21 14:07:38
6UMSXW36XU,Mr. Timothy Olson,Send Money,0.0,2533.0,724.01,Tuesday,2023-11-21 14:07:38
HIA4PH13C3,Mpesa Charges,Mpesa Charges,0.0,23.0,3257.01,Tuesday,2023-11-21 13:52:09
LTDERP3N20,Mr. Timothy Olson,Send Money,0.0,1400.0,3280.01,Tuesday,2023-11-21 13:52:09
INTA22VMA1,Ochoa LLC,Till No,0.0,65.0,4680.01,Tuesday,2023-11-21 08:44:08
M7SEILYJ3T,"Hill, Matthews and Martin",Till No,0.0,300.0,4745.01,Monday,2023-11-20 12:19:56
8UXAC3HGGW,"Smith, Mcknight and Brown",Till No,0.0,55.0,5045.01,Sunday,2023-11-19 19:06:20
RDLFQ0XM3E,Mpesa Charges,Mpesa Charges,0.0,5.0,5100.01,Saturday,2023-11-18 23:09:15
PA2RKRQTT5,White-Fowler,Pay Bill,0.0,500.0,5105.01,Saturday,2023-11-18 23:09:15
8K4BMDEKKA,"Ramirez, Morales and Morris",Bank Transfer,5000.0,0.0,5605.01,Saturday,2023-11-18 21:09:57
N8GB3SG665,Mpesa Charges,Mpesa Charges,0.0,7.0,605.01,Saturday,2023-11-18 17:18:07
FRJDVTSK9H,Matthew Garcia,Send Money,0.0,250.0,612.01,Saturday,2023-11-18 17:18:07
KHVBDZD5K9,Mpesa Charges,Mpesa Charges,0.0,7.0,862.01,Saturday,2023-11-18 10:42:14
VS6K5AEEFA,Madison Pugh,Send Money,0.0,290.0,869.01,Saturday,2023-11-18 10:42:14
I506SI9Q32,"Smith, Mcknight and Brown",Till No,0.0,20.0,1159.01,Friday,2023-11-17 18:58:41
U6T3G3E0YP,"Johnson, Mercado and Williams",Till No,0.0,700.0,1179.01,Friday,2023-11-17 18:41:13
5QXFEE4A9J,Mpesa Charges,Mpesa Charges,0.0,7.0,1879.01,Friday,2023-11-17 18:33:01
DFM742O7P6,Joel Ross,Send Money,0.0,260.0,1886.01,Friday,2023-11-17 18:33:01
7LKQ2S6ELB,"Gomez, Rice and Simpson",Till No,0.0,965.0,2146.01,Friday,2023-11-17 18:24:28
FQPO7Z7RH3,Alexander Jackson,Send Money,0.0,50.0,3111.01,Friday,2023-11-17 18:19:25
CN7GQ4C6M4,Mpesa Charges,Mpesa Charges,0.0,10.0,3161.01,Thursday,2023-11-16 12:38:02
3I2EWF97QM,"Nguyen, Smith and Andrews",Pay Bill,0.0,537.0,3171.01,Thursday,2023-11-16 12:38:02
YQBNSQ9VNN,Mpesa Charges,Mpesa Charges,0.0,33.0,3708.01,Wednesday,2023-11-15 20:09:46
61VZIH5BIS,Michael Benitez,Send Money,0.0,2138.0,3741.01,Wednesday,2023-11-15 20:09:46
Z9LETUENUA,Washington Ltd,Bank Transfer,5000.0,0.0,5879.01,Wednesday,2023-11-15 20:04:41
GN5V50CD6R,"Carlson, Hanson and Martin",Till No,0.0,65.0,879.01,Wednesday,2023-11-15 10:03:02
BUKXO4ZFNY,"Smith, Mcknight and Brown",Till No,0.0,100.0,944.01,Tuesday,2023-11-14 20:11:34
A8YTAGUY0V,Lydia Perry,Send Money,0.0,70.0,1044.01,Tuesday,2023-11-14 07:45:28
ECN9L757T9,Buck Group,Till No,0.0,1630.0,1114.01,Monday,2023-11-13 18:09:44
K3RRCFQ8DG,Donald Yang DDS,Send Money,0.0,50.0,2744.01,Sunday,2023-11-12 21:29:29
ULLLEK1RTX,Mercado-Arnold,Till No,0.0,200.0,2794.01,Sunday,2023-11-12 21:23:56
ZO4KDAD8PJ,"Carlson, Hanson and Martin",Till No,0.0,190.0,2994.01,Saturday,2023-11-11 20:37:01
H98242RFFH,Mpesa Charges,Mpesa Charges,0.0,34.0,3184.01,Saturday,2023-11-11 20:34:16
SQ1A73B5IC,Williams and Sons,Pay Bill,0.0,3521.0,3218.01,Saturday,2023-11-11 20:34:16
GRRG0882UJ,Mayer-Scott,Bank Transfer,5000.0,0.0,6739.01,Saturday,2023-11-11 20:30:55
2I3NHGQ8UF,Mpesa Charges,Mpesa Charges,0.0,23.0,1739.01,Saturday,2023-11-11 20:15:03
UPPPVPZGSR,Marissa Taylor,Send Money,0.0,1288.0,1762.01,Saturday,2023-11-11 20:15:03
EOWC1TELH5,Mpesa Charges,Mpesa Charges,0.0,23.0,3050.01,Saturday,2023-11-11 16:06:20
EM5Q6RLFOE,Brian Nguyen,Send Money,0.0,1160.0,3073.01,Saturday,2023-11-11 16:06:20
UN9KBY4Y3K,Dr. Mark Potts,Send Money,0.0,50.0,4233.01,Saturday,2023-11-11 13:46:05
1YB89GJLEJ,Lopez LLC,Till No,0.0,450.0,4283.01,Friday,2023-11-10 20:16:38
OGBNJ1R6D0,Lopez LLC,Till No,0.0,310.0,4733.01,Friday,2023-11-10 20:03:17
5B5CNC4XMS,Stephenson Ltd,Till No,0.0,100.0,5043.01,Friday,2023-11-10 19:53:16
G827H9NIXN,"Anderson, Thompson and Rogers",Till No,0.0,550.0,5143.01,Friday,2023-11-10 19:49:01
ZIEZ8TTK66,Payne and Sons,Till No,0.0,70.0,5693.01,Friday,2023-11-10 08:35:47
SYRGBGN61B,Fisher Inc,Till No,0.0,300.0,5763.01,Friday,2023-11-10 08:31:42
55ZWV87EG4,Mpesa Charges,Mpesa Charges,0.0,5.0,6063.01,Friday,2023-11-10 07:39:56
9ALKI5AQCV,White-Fowler,Pay Bill,0.0,500.0,6068.01,Friday,2023-11-10 07:39:56
A613TQU8ZZ,Martinez-Walsh,Till No,0.0,200.0,6568.01,Thursday,2023-11-09 21:02:36
Q94YNK8D20,Mpesa Charges,Mpesa Charges,0.0,13.0,6768.01,Thursday,2023-11-09 20:42:31
HNNZW32B7S,David Allison,Send Money,0.0,1000.0,6781.01,Thursday,2023-11-09 20:42:31
8VGWFT44SO,"Hill, Matthews and Martin",Till No,0.0,300.0,7781.01,Thursday,2023-11-09 10:01:18
43O2NNULLY,Airtime Purchase,Airtime Purchase,0.0,500.0,8081.01,Wednesday,2023-11-08 19:13:08
VAV2SZXXDZ,Mpesa Charges,Mpesa Charges,0.0,7.0,8581.01,Wednesday,2023-11-08 18:23:02
WG7BI7QMQ5,Alicia Chapman,Send Money,0.0,200.0,8588.01,Wednesday,2023-11-08 18:23:02
58O7SXVHN9,Griffith PLC,Till No,0.0,140.0,8788.01,Wednesday,2023-11-08 08:12:55
FY3VUF1KLO,Griffith PLC,Till No,0.0,190.0,8928.01,Tuesday,2023-11-07 08:50:46
GAVHJT40GT,"Smith, Mcknight and Brown",Till No,0.0,80.0,9118.01,Monday,2023-11-06 19:50:36
APDKZNUTKY,Mpesa Charges,Mpesa Charges,0.0,83.0,9198.01,Monday,2023-11-06 07:09:53
ZQKHG88DVV,"Caldwell, King and Taylor",Pay Bill,0.0,31500.0,9281.01,Monday,2023-11-06 07:09:53
7HPBE77KFR,"Harris, Graves and Gates",Bank Transfer,40000.0,0.0,40781.01,Monday,2023-11-06 07:09:09
87SWFYE6Q3,Mpesa Charges,Mpesa Charges,0.0,13.0,781.01,Sunday,2023-11-05 23:00:23
ACHHZ1IUZD,Jeremy Kennedy,Send Money,0.0,1000.0,794.01,Sunday,2023-11-05 23:00:23
V8YXZ94ATD,Buck Group,Till No,0.0,1530.0,1794.01,Saturday,2023-11-04 22:20:39
9KJYCY84JI,"Martinez, Winters and Bowen",Till No,0.0,645.0,3324.01,Saturday,2023-11-04 21:07:20
5L00J72BQ2,Jones LLC,Till No,0.0,300.0,3969.01,Saturday,2023-11-04 18:21:07
G099CA6RIW,Jones LLC,Till No,0.0,200.0,4269.01,Saturday,2023-11-04 18:16:19
B6V4PFZEMG,William Khan,Pochi,0.0,50.0,4469.01,Saturday,2023-11-04 17:23:58
2GLC00OORL,Kelly Patterson,Send Money,0.0,100.0,4519.01,Saturday,2023-11-04 13:26:02
75I2DPFQQP,Madison Pugh,Send Money,0.0,100.0,4619.01,Saturday,2023-11-04 10:54:32
4AM372BSX8,"Franklin, Hatfield and Wilson",Till No,0.0,180.0,4719.01,Saturday,2023-11-04 10:50:27
6RC0R1GZ3M,Lopez LLC,Till No,0.0,400.0,4899.01,Friday,2023-11-03 20:39:27
EJUE3W74DP,Zimmerman-Young,Bank Transfer,5000.0,0.0,5299.01,Friday,2023-11-03 20:36:39
RPW1J463YB,Lopez LLC,Till No,0.0,230.0,299.01,Friday,2023-11-03 20:29:13
4ATHJQL86F,Mpesa Charges,Mpesa Charges,0.0,7.0,529.01,Friday,2023-11-03 13:59:55
1XKKVYFRFB,David Ford,Send Money,0.0,200.0,536.01,Friday,2023-11-03 13:59:55
OX0IEG2URK,Cooley-Frost,Till No,0.0,50.0,736.01,Friday,2023-11-03 13:49:30
BZUM8G51SI,Mpesa Charges,Mpesa Charges,0.0,7.0,786.01,Friday,2023-11-03 13:43:53
DCD6K1TZVL,Justin Stewart,Send Money,0.0,200.0,793.01,Friday,2023-11-03 13:43:53
IZH6328R20,Mpesa Charges,Mpesa Charges,0.0,7.0,993.01,Friday,2023-11-03 13:09:41
N7O24B3H07,Mark Davenport,Send Money,0.0,310.0,1000.01,Friday,2023-11-03 13:09:41
VFH8F31SRV,Cooley-Frost,Till No,0.0,200.0,1310.01,Friday,2023-11-03 13:03:52
2T2DK60J97,Mpesa Charges,Mpesa Charges,0.0,5.0,1510.01,Friday,2023-11-03 12:35:32
JQFF0CCIXD,Walls-Parker,Pay Bill,0.0,300.0,1515.01,Friday,2023-11-03 12:35:32
A1GJM20E5P,Airtime Purchase,Airtime Purchase,0.0,50.0,1815.01,Friday,2023-11-03 12:33:58
PBU3OG7E89,Griffith PLC,Till No,0.0,140.0,1865.01,Friday,2023-11-03 07:48:29
DYB4OCPUIP,Other,Other,0.0,1000.0,2005.01,Thursday,2023-11-02 13:16:26
3RJCBR44CM,Griffith PLC,Till No,0.0,80.0,3005.01,Thursday,2023-11-02 08:59:54
2A48LLN7WG,Mpesa Charges,Mpesa Charges,0.0,5.0,3085.01,Thursday,2023-11-02 08:57:59
6G79GAZD4C,White-Fowler,Pay Bill,0.0,500.0,3090.01,Thursday,2023-11-02 08:57:59
OEDTAQ4NXR,"Smith, Mcknight and Brown",Till No,0.0,50.0,3590.01,Wednesday,2023-11-01 19:37:22
VDRN0B4QN9,"Franklin, Hatfield and Wilson",Till No,0.0,200.0,3640.01,Wednesday,2023-11-01 13:34:05
T42YDHN51D,"Keith, Phillips and Singleton",Pay Bill,0.0,2999.0,3840.01,Wednesday,2023-11-01 08:10:02
FLOD92YK3B,Richards-Hudson,Bank Transfer,5000.0,0.0,6839.01,Wednesday,2023-11-01 08:09:17
P6JXL569C5,Mpesa Charges,Mpesa Charges,0.0,23.0,1839.01,Tuesday,2023-10-31 20:59:34
BIBPA08X5I,Casey Cox,Send Money,0.0,1428.0,1862.01,Tuesday,2023-10-31 20:59:34
3TFCLAQ569,Nichols LLC,Till No,0.0,1800.0,3290.01,Tuesday,2023-10-31 19:16:08
H0U7NHTZSF,Mpesa Charges,Mpesa Charges,0.0,13.0,5090.01,Tuesday,2023-10-31 15:51:57
Q5XAP90ZTB,Beverly Taylor,Send Money,0.0,700.0,5103.01,Tuesday,2023-10-31 15:51:57
8KQIWH8K7P,Mpesa Charges,Mpesa Charges,0.0,23.0,5803.01,Tuesday,2023-10-31 14:32:32
ECT1ZIX4GI,Elizabeth Taylor,Send Money,0.0,1048.0,5826.01,Tuesday,2023-10-31 14:32:32
6J6KAF6GWB,Kelsey Potter,Receive Money,3500.0,0.0,6874.01,Tuesday,2023-10-31 04:48:56
0Y30BZS9IE,Charlotte Davis,Receive Money,3500.0,0.0,6874.01,Tuesday,2023-10-31 04:48:56
KX7VYTG5NO,Mpesa Charges,Mpesa Charges,0.0,13.0,3374.01,Monday,2023-10-30 20:48:18
RBKZIBZAZZ,Kellie Gallagher,Send Money,0.0,568.0,3387.01,Monday,2023-10-30 20:48:18
UQDZYR9RGF,Mpesa Charges,Mpesa Charges,0.0,7.0,3955.01,Monday,2023-10-30 15:26:31
B89F75M0RZ,Chad Bradley,Send Money,0.0,500.0,3962.01,Monday,2023-10-30 15:26:31
19LCMYMJWH,"Hill, Matthews and Martin",Till No,0.0,300.0,4462.01,Monday,2023-10-30 12:51:06
7RODHR2MQB,Mpesa Charges,Mpesa Charges,0.0,7.0,4762.01,Sunday,2023-10-29 20:56:22
IMLBSMW5AQ,Roy Gray,Send Money,0.0,400.0,4769.01,Sunday,2023-10-29 20:56:22
V6ZJON3J99,Thomas Wilson,Send Money,0.0,100.0,5169.01,Saturday,2023-10-28 18:15:54
C7FD8XVUV4,Woods-Walker,Till No,0.0,2249.0,5269.01,Saturday,2023-10-28 18:03:09
IZUW3C6O36,Mpesa Charges,Mpesa Charges,0.0,5.0,7518.01,Saturday,2023-10-28 17:22:35
99WJZLDKUC,Harrison and Sons,Pay Bill,0.0,240.0,7523.01,Saturday,2023-10-28 17:22:35
EWIONFSURX,Elizabeth Keith,Pochi,0.0,100.0,7763.01,Saturday,2023-10-28 16:00:24
5NHLX8LHOU,Mpesa Charges,Mpesa Charges,0.0,62.0,7863.01,Saturday,2023-10-28 11:53:03
Z06ALJRAFL,Edwards and Sons,Pay Bill,0.0,17550.0,7925.01,Saturday,2023-10-28 11:53:03
VS96MY13YD,Sanders-Castillo,Till No,0.0,200.0,25475.01,Saturday,2023-10-28 09:34:47
ZPSD1YP1V4,Jones Inc,Till No,0.0,100.0,25675.01,Saturday,2023-10-28 09:30:16
K1QLLPG0I6,"Smith, Mcknight and Brown",Till No,0.0,50.0,25775.01,Friday,2023-10-27 20:22:22
IL7H6SIV3M,Benjamin Villanueva,Send Money,0.0,30.0,25825.01,Friday,2023-10-27 16:59:27
U977HF6NSO,Mpesa Charges,Mpesa Charges,0.0,5.0,25855.01,Thursday,2023-10-26 20:57:37
30I7SERLNJ,White-Fowler,Pay Bill,0.0,500.0,25860.01,Thursday,2023-10-26 20:57:37
19C738VYCJ,Griffith PLC,Till No,0.0,100.0,26360.01,Thursday,2023-10-26 20:47:21
5MMXZVI2B9,Mpesa Charges,Mpesa Charges,0.0,3.3,26460.01,Wednesday,2023-10-25 15:31:47
0SHXPS7T2F,Garcia-Lopez,Till No,0.0,600.0,26463.31,Wednesday,2023-10-25 15:31:47
TV7FF7V4R5,Bailey Ltd,Pay Bill,0.0,250.0,27063.31,Wednesday,2023-10-25 15:05:56
LQQHT6NKK5,Mpesa Charges,Mpesa Charges,0.0,70.78,27313.31,Wednesday,2023-10-25 14:56:06
YV5HOU6LLS,"Osborne, Keith and Ellison",Till No,0.0,12870.0,27384.09,Wednesday,2023-10-25 14:56:06
NIZW3NH0ZB,Mpesa Charges,Mpesa Charges,0.0,7.0,40254.09,Wednesday,2023-10-25 14:42:45
SSAFCXEL2E,Cody Phillips,Send Money,0.0,200.0,40261.09,Wednesday,2023-10-25 14:42:45
3IGO707A8C,Mpesa Charges,Mpesa Charges,0.0,100.0,40461.09,Wednesday,2023-10-25 14:37:38
3NZLWPJXYX,Jenny Gallagher,Send Money,0.0,12000.0,40561.09,Wednesday,2023-10-25 14:37:38
FH3BEHJ6YG,Mpesa Charges,Mpesa Charges,0.0,57.0,52561.09,Wednesday,2023-10-25 12:46:17
791OQLU1JM,Jennifer Mcdonald,Send Money,0.0,4500.0,52618.09,Wednesday,2023-10-25 12:46:17
5ZLXLAW11C,Mpesa Charges,Mpesa Charges,0.0,24.0,57118.09,Wednesday,2023-10-25 12:17:48
5E0WOQ1FB2,"Foster, Hess and Arroyo",Pay Bill,0.0,78231.0,57142.09,Wednesday,2023-10-25 12:17:48
30S2FVF7WI,"Lee, Rollins and Collins",Bank Transfer,120000.0,0.0,135373.09,Wednesday,2023-10-25 12:14:06
0FDV6U84IR,Mpesa Charges,Mpesa Charges,0.0,7.0,15373.09,Wednesday,2023-10-25 11:34:21
VIE0NTYEKP,Kelly Cook,Send Money,0.0,350.0,15380.09,Wednesday,2023-10-25 11:34:21
A1H1US35BG,Mpesa Charges,Mpesa Charges,0.0,67.0,15730.09,Wednesday,2023-10-25 10:57:24
BPKRAF1CPO,"Bridges, Blackwell and Meyer",Pay Bill,0.0,23500.0,15797.09,Wednesday,2023-10-25 10:57:24
6RAP0SML6M,Martin Group,Pay Bill,0.0,20.0,39297.09,Wednesday,2023-10-25 10:37:53
EZ6EUWNBS5,Mpesa Charges,Mpesa Charges,0.0,13.0,39317.09,Wednesday,2023-10-25 10:36:00
B6FIEBLDC5,Brian Johnson,Send Money,0.0,860.0,39330.09,Wednesday,2023-10-25 10:36:00
DBKACOBMJ4,"Kelly, Young and Clark",Bank Transfer,40000.0,0.0,40190.09,Wednesday,2023-10-25 10:35:21
PRDD047FVJ,"Smith, Mcknight and Brown",Till No,0.0,30.0,190.09,Tuesday,2023-10-24 19:35:29
WGUDSEY8P3,Mpesa Charges,Mpesa Charges,0.0,13.0,220.09,Tuesday,2023-10-24 14:20:11
BFIJZJJXQS,Michael Ho,Send Money,0.0,870.0,233.09,Tuesday,2023-10-24 14:20:11
SEKFTRP7N0,Mpesa Charges,Mpesa Charges,0.0,53.0,1103.09,Tuesday,2023-10-24 10:12:25
1SCB4Y32X4,Kelsey Potter,Send Money,0.0,3000.0,1156.09,Tuesday,2023-10-24 10:12:25
JZVZPADOQJ,Charlotte Davis,Send Money,0.0,3000.0,1156.09,Tuesday,2023-10-24 10:12:25
1Y5UHC8JPQ,Mpesa Charges,Mpesa Charges,0.0,13.0,4156.09,Tuesday,2023-10-24 09:34:24
X596KJ5F9S,Jesus Carson,Send Money,0.0,880.0,4169.09,Tuesday,2023-10-24 09:34:24
4QD88K25L8,Thomas Group,Bank Transfer,5000.0,0.0,5049.09,Tuesday,2023-10-24 09:26:30
KHF7XOTWJ9,Mpesa Charges,Mpesa Charges,0.0,5.0,49.09,Saturday,2023-10-21 21:23:30
3LHQHTCO87,White-Fowler,Pay Bill,0.0,250.0,54.09,Saturday,2023-10-21 21:23:30
97RIEOCS4R,"Smith, Mcknight and Brown",Till No,0.0,45.0,304.09,Saturday,2023-10-21 19:04:56
H71POUKO56,Zachary Diaz,Send Money,0.0,50.0,349.09,Saturday,2023-10-21 19:03:05
S2XN6FOB17,"Gomez, Rice and Simpson",Till No,0.0,735.0,399.09,Saturday,2023-10-21 18:57:05
X0IH6DWHS4,Mpesa Charges,Mpesa Charges,0.0,7.0,1134.09,Saturday,2023-10-21 18:45:52
9HAXEZG9E3,Dr. Mark Potts,Send Money,0.0,300.0,1141.09,Saturday,2023-10-21 18:45:52
W84K6UDL9S,Moreno-Clark,Till No,0.0,600.0,1441.09,Saturday,2023-10-21 18:38:06
OZ9IG18CGU,Mpesa Charges,Mpesa Charges,0.0,7.0,2041.09,Saturday,2023-10-21 18:30:38
8LMKUA7XKU,Joel Ross,Send Money,0.0,350.0,2048.09,Saturday,2023-10-21 18:30:38
7TVKZSJ338,Mpesa Charges,Mpesa Charges,0.0,34.0,2398.09,Saturday,2023-10-21 16:57:22
97R8X4YGNN,Williams and Sons,Pay Bill,0.0,4856.0,2432.09,Saturday,2023-10-21 16:57:22
VPIFD7HDSS,Jeremy Simmons,Receive Money,3150.0,0.0,7288.09,Saturday,2023-10-21 15:36:35
BDIB4S08N3,"Johnson, Craig and Garcia",Till No,0.0,50.0,4138.09,Saturday,2023-10-21 12:02:11
Q7LUIP183S,Sanders-Castillo,Till No,0.0,100.0,4188.09,Saturday,2023-10-21 11:58:54
JO6I2X0DFF,Lindsey Johnson,Send Money,0.0,30.0,4288.09,Saturday,2023-10-21 08:21:55
6A4Y8I9SO1,Mpesa Charges,Mpesa Charges,0.0,13.0,4318.09,Friday,2023-10-20 23:20:14
BVGEY5ABU3,Joanna Moore,Send Money,0.0,600.0,4331.09,Friday,2023-10-20 23:20:14
RLP5RV7BSC,"Gilbert, Wagner and Fleming",Till No,0.0,400.0,4931.09,Friday,2023-10-20 23:17:46
87NM5CDP99,"Mayer, Livingston and Smith",Till No,0.0,7620.0,5331.09,Friday,2023-10-20 22:30:36
UANG7Y6VSH,Mcdowell-Perez,Bank Transfer,10000.0,0.0,12951.09,Friday,2023-10-20 22:29:08
Q2ODALQW66,Mpesa Charges,Mpesa Charges,0.0,7.0,2951.09,Friday,2023-10-20 18:02:56
FJ9RTOV4A6,Curtis Jimenez,Send Money,0.0,250.0,2958.09,Friday,2023-10-20 18:02:56
FY3V8I82RI,"Smith, Mcknight and Brown",Till No,0.0,160.0,3208.09,Friday,2023-10-20 15:05:16
EOC5TUK1HI,"Carlson, Hanson and Martin",Till No,0.0,140.0,3368.09,Thursday,2023-10-19 19:32:14
D9HG20FSYJ,Mcgee-Palmer,Till No,0.0,190.0,3508.09,Thursday,2023-10-19 19:26:14
Z6IFMRVEBI,Griffith PLC,Till No,0.0,80.0,3698.09,Thursday,2023-10-19 07:58:15
T3035CRJEL,"Ho, Howell and Welch",Till No,0.0,80.0,3778.09,Tuesday,2023-10-17 19:53:06
PRFWS0WKWF,"Hill, Matthews and Martin",Till No,0.0,300.0,3858.09,Tuesday,2023-10-17 13:39:54
EKP845YXN6,"Ho, Howell and Welch",Till No,0.0,170.0,4158.09,Monday,2023-10-16 19:14:41
MYR7M43IG5,Mpesa Charges,Mpesa Charges,0.0,5.0,4328.09,Sunday,2023-10-15 20:38:23
VNKLR2WOV1,White-Fowler,Pay Bill,0.0,500.0,4333.09,Sunday,2023-10-15 20:38:23
MXK3NSPB15, M-PESA Overdraw,Fuliza Loan Repayment,0.0,166.91,4833.09,Sunday,2023-10-15 20:36:40
7DC2KA15LF,Thompson and Sons,Bank Transfer,5000.0,0.0,5000.0,Sunday,2023-10-15 20:36:40
NYSJYG464D,"Lee, Greer and Mccullough",Till No,0.0,630.0,0.0,Sunday,2023-10-15 09:06:12
STOIC4MZPF,Fuliza Loan,Fuliza Loan,165.25,0.0,630.0,Sunday,2023-10-15 09:06:12
53I86JH3HO,Sanders-Castillo,Till No,0.0,240.0,464.75,Saturday,2023-10-14 19:05:54
LZJFUQ2C84,Richard Brown,Pochi,0.0,70.0,704.75,Saturday,2023-10-14 18:25:06
XOBNVXWAZ5,Tiffany Carpenter,Send Money,0.0,70.0,774.75,Saturday,2023-10-14 14:32:35
YH6WEFXHFO,"Johnson, Craig and Garcia",Till No,0.0,140.0,844.75,Saturday,2023-10-14 12:02:54
5LJWYS7NVI,Sanders-Castillo,Till No,0.0,120.0,984.75,Saturday,2023-10-14 12:00:44
HDO1K8MO66,"Smith, Mcknight and Brown",Till No,0.0,130.0,1104.75,Friday,2023-10-13 19:11:45
8HEP4ABNWZ,"Smith, Mcknight and Brown",Till No,0.0,90.0,1234.75,Thursday,2023-10-12 19:44:29
KU44JV8DD9,Mpesa Charges,Mpesa Charges,0.0,7.0,1324.75,Thursday,2023-10-12 19:40:17
U7XZS07R01,Alicia Chapman,Send Money,0.0,180.0,1331.75,Thursday,2023-10-12 19:40:17
61ZPUBE9GJ,Mpesa Charges,Mpesa Charges,0.0,23.0,1511.75,Wednesday,2023-10-11 18:53:38
50Q5FXC93J,Patricia Stewart,Send Money,0.0,1319.0,1534.75,Wednesday,2023-10-11 18:53:38
AHBRKQ4CP3,Griffith PLC,Till No,0.0,200.0,2853.75,Wednesday,2023-10-11 13:54:04
U0H983ZCMT,Griffith PLC,Till No,0.0,80.0,3053.75,Wednesday,2023-10-11 08:35:47
U9CUDYF1EY,Lopez LLC,Till No,0.0,480.0,3133.75,Tuesday,2023-10-10 20:04:14
8WNXKBCN8L,Walker Inc,Till No,0.0,300.0,3613.75,Monday,2023-10-09 18:51:55
OOZ3IAJOLS,Mpesa Charges,Mpesa Charges,0.0,5.0,3913.75,Monday,2023-10-09 07:49:37
0OVNLK3RJJ,White-Fowler,Pay Bill,0.0,500.0,3918.75,Monday,2023-10-09 07:49:37
SX3BAY0QNZ,Gary Hart,Pochi,0.0,70.0,4418.75,Monday,2023-10-09 07:24:27
2SKFF2Q6BD,Richard Beck,Pochi,0.0,70.0,4488.75,Saturday,2023-10-07 17:43:48
L5BK1TGBWI,Jones Inc,Till No,0.0,200.0,4558.75,Saturday,2023-10-07 17:28:17
A7YIUPNQNS,Mpesa Charges,Mpesa Charges,0.0,7.0,4758.75,Saturday,2023-10-07 17:22:24
GS8PKJ73OB,Lindsey Johnson,Send Money,0.0,145.0,4765.75,Saturday,2023-10-07 17:22:24
RGG2IZLF7K,"Hill, Matthews and Martin",Till No,0.0,300.0,4910.75,Saturday,2023-10-07 17:00:11
AR91E1VEKK,Brown LLC,Bank Transfer,5000.0,0.0,5210.75,Saturday,2023-10-07 16:59:59
2ACRHH3P3M,Smith-Lane,Till No,0.0,1150.0,210.75,Saturday,2023-10-07 16:20:38
NO6BU9ZXJ8,Patrick Ltd,Till No,0.0,500.0,1360.75,Saturday,2023-10-07 16:13:46
AINQ0C2OU8,"Gomez, Rice and Simpson",Till No,0.0,218.0,1860.75,Saturday,2023-10-07 10:41:11
YJ6YEJN3Q7,Mpesa Charges,Mpesa Charges,0.0,7.0,2078.75,Saturday,2023-10-07 10:32:11
TXKR5WV1UC,Dr. Mark Potts,Send Money,0.0,370.0,2085.75,Saturday,2023-10-07 10:32:11
JC6ALTD9Q9,Alicia Chapman,Send Money,0.0,50.0,2455.75,Friday,2023-10-06 18:14:45
QCKCPRY2WD,Yates-Dunn,Pay Bill,0.0,80.0,2505.75,Friday,2023-10-06 17:00:03
NGQ4V46GCD,Mpesa Charges,Mpesa Charges,0.0,13.0,2585.75,Friday,2023-10-06 16:35:54
A5242M3SKI,Eileen Rodriguez DVM,Send Money,0.0,600.0,2598.75,Friday,2023-10-06 16:35:54
SHKX9H5BD7,Griffin Group,Till No,0.0,1020.0,3198.75,Friday,2023-10-06 16:30:09
DICK0K28MQ,Yates-Dunn,Pay Bill,0.0,70.0,4218.75,Friday,2023-10-06 12:54:40
45CSO95V48,Sanders-Castillo,Till No,0.0,200.0,4288.75,Thursday,2023-10-05 19:31:29
EH405AI4KL,Airtime Purchase,Airtime Purchase,0.0,500.0,4488.75,Thursday,2023-10-05 14:07:30
A4JIW09Q96,Airtime Purchase,Airtime Purchase,0.0,500.0,4988.75,Thursday,2023-10-05 13:53:08
W6DHUBXDMV,Airtime Purchase,Airtime Purchase,0.0,500.0,5488.75,Thursday,2023-10-05 13:26:44
TBWD1CEXX5,Shwari Loan Repayment,MShwari Loan,0.0,1635.0,5988.75,Thursday,2023-10-05 13:24:33
EFELLCA2WQ,Other,Other,0.0,1000.0,7623.75,Thursday,2023-10-05 13:23:30
6NK55BSZCJ,Mpesa Charges,Mpesa Charges,0.0,83.0,8623.75,Thursday,2023-10-05 13:21:39
1DK5BRCY07,"Caldwell, King and Taylor",Pay Bill,0.0,31300.0,8706.75,Thursday,2023-10-05 13:21:39
GQ1015MQGS,Gonzales LLC,Bank Transfer,40000.0,0.0,40006.75,Thursday,2023-10-05 13:19:58
4Q1E0SPP8A,"Smith, Mcknight and Brown",Till No,0.0,50.0,6.75,Wednesday,2023-10-04 19:49:28
Z9U3YQ6I75,Alicia Chapman,Send Money,0.0,60.0,56.75,Wednesday,2023-10-04 19:45:52
VD37QFPPAE,Mpesa Charges,Mpesa Charges,0.0,5.0,116.75,Wednesday,2023-10-04 19:41:02
QKFJC4OJTN,White-Fowler,Pay Bill,0.0,200.0,121.75,Wednesday,2023-10-04 19:41:02
H1QM3W5OFW,Griffith PLC,Till No,0.0,60.0,321.75,Wednesday,2023-10-04 08:54:47
03G4AIHMKI,Brown-Anderson,Till No,0.0,96.0,381.75,Tuesday,2023-10-03 20:00:56
U2IX0902LZ,"Smith, Mcknight and Brown",Till No,0.0,85.0,477.75,Tuesday,2023-10-03 19:59:28
E2AWJABOPE,Mpesa Charges,Mpesa Charges,0.0,13.0,562.75,Monday,2023-10-02 20:46:35
FBSR57YQKC,David Allison,Send Money,0.0,1000.0,575.75,Monday,2023-10-02 20:46:35
50VZ51A7KM,Shwari Loan Request,MShwari Loan,0.0,0.0,1575.75,Monday,2023-10-02 20:45:58
JM1VIV5Q41,Shwari Loan Disburse,MShwari Loan,1500.0,0.0,1575.75,Monday,2023-10-02 20:45:58
75SJGZG6CO,Mpesa Charges,Mpesa Charges,0.0,23.0,75.75,Sunday,2023-10-01 22:01:25
W8SGBG18M1,Joseph Perez,Send Money,0.0,1100.0,98.75,Sunday,2023-10-01 22:01:25
UTXU5DPWZ2,Dorothy Price,Send Money,0.0,1100.0,98.75,Sunday,2023-10-01 22:01:25
0PL2UYOF67,"Ho, Howell and Welch",Till No,0.0,60.0,1198.75,Sunday,2023-10-01 19:30:30
VZACGWXE96,"Smith, Mcknight and Brown",Till No,0.0,90.0,1258.75,Sunday,2023-10-01 19:27:08
EXMMEZNUX0,"Franklin, Hatfield and Wilson",Till No,0.0,300.0,1348.75,Sunday,2023-10-01 13:35:40
LSIO1NUWF7,"Keith, Phillips and Singleton",Pay Bill,0.0,2999.0,1648.75,Sunday,2023-10-01 01:19:07
2PO7ZV1T8Q,Mpesa Charges,Mpesa Charges,0.0,53.0,4647.75,Sunday,2023-10-01 01:01:56
3HN2W3W8KT,Jeremy Kennedy,Send Money,0.0,3500.0,4700.75,Sunday,2023-10-01 01:01:56
U50CJQ7K5X,Merritt and Sons,Till No,0.0,1160.0,8200.75,Sunday,2023-10-01 00:36:54
HTUSENDOSC,Mpesa Charges,Mpesa Charges,0.0,7.0,9360.75,Saturday,2023-09-30 20:32:52
PKRVZ86BY1,Claudia Roberts,Pochi,0.0,240.0,9367.75,Saturday,2023-09-30 20:32:52
7DUGO65H1O,Mpesa Charges,Mpesa Charges,0.0,7.0,9607.75,Saturday,2023-09-30 16:57:49
9SJCQBFYHF,Michael Duffy,Send Money,0.0,400.0,9614.75,Saturday,2023-09-30 16:57:49
TDLFU4WBW6,Jeremy Simmons,Receive Money,10000.0,0.0,10014.75,Saturday,2023-09-30 16:03:05
SW1Z3QUAZL,"Smith, Mcknight and Brown",Till No,0.0,60.0,14.75,Friday,2023-09-29 20:08:13
8FMKVTCYSN,Danielle King,Send Money,0.0,80.0,74.75,Friday,2023-09-29 14:45:48
96JQVDHVTT,Mpesa Charges,Mpesa Charges,0.0,5.0,154.75,Friday,2023-09-29 13:44:43
KKIS9KAKVW,Yates-Dunn,Pay Bill,0.0,140.0,159.75,Friday,2023-09-29 13:44:43
63IF10SZRY,Sarah Clark,Send Money,0.0,80.0,299.75,Friday,2023-09-29 09:59:31
0KOL8LRWD7,Mpesa Charges,Mpesa Charges,0.0,7.0,379.75,Thursday,2023-09-28 19:50:52
MF9CPDHRXQ,Alicia Chapman,Send Money,0.0,120.0,386.75,Thursday,2023-09-28 19:50:52
1JQ3EKAO3S,Sonya Greene,Send Money,0.0,65.0,506.75,Thursday,2023-09-28 08:52:56
XV32T2QZ8T,"Smith, Mcknight and Brown",Till No,0.0,40.0,571.75,Wednesday,2023-09-27 19:57:45
0X5CC9RC2R,Mpesa Charges,Mpesa Charges,0.0,5.0,611.75,Wednesday,2023-09-27 10:39:34
PMEZWR8BJJ,White-Fowler,Pay Bill,0.0,500.0,616.75,Wednesday,2023-09-27 10:39:34
J4VHPO8P0O,Mpesa Charges,Mpesa Charges,0.0,33.0,1116.75,Monday,2023-09-25 19:40:58
HIXCXWJXHR,Chelsea Jackson,Send Money,0.0,2269.0,1149.75,Monday,2023-09-25 19:40:58
C1H3ADQSZH,Mpesa Charges,Mpesa Charges,0.0,7.0,3418.75,Monday,2023-09-25 19:34:10
WFOMOQ89HZ,Sonya Greene,Send Money,0.0,200.0,3425.75,Monday,2023-09-25 19:34:10
SOWHK9GWZY,Barnes LLC,Bank Transfer,2000.0,0.0,3625.75,Monday,2023-09-25 19:18:01
TW1GZEPTTL,"Hill, Matthews and Martin",Till No,0.0,300.0,1625.75,Monday,2023-09-25 14:25:45
DIRO5Q33ER,Kaylee Yoder,Send Money,0.0,30.0,1925.75,Sunday,2023-09-24 17:38:48
XERE9G6ZT0,Scott Pugh,Send Money,0.0,70.0,1955.75,Sunday,2023-09-24 12:40:57
BFDQBU9F21,Brown-Anderson,Till No,0.0,1100.0,2025.75,Saturday,2023-09-23 16:46:57
M23EVTIZA0,Guerra Group,Bank Transfer,3000.0,0.0,3125.75,Saturday,2023-09-23 16:45:43
8ET0HTHWX4,"Smith, Mcknight and Brown",Till No,0.0,90.0,125.75,Saturday,2023-09-23 16:44:37
4CDUMPXZ6T,Mpesa Charges,Mpesa Charges,0.0,7.0,215.75,Saturday,2023-09-23 12:24:08
M9HUJ30BO8,Dr. Mark Potts,Send Money,0.0,350.0,222.75,Saturday,2023-09-23 12:24:08
5BKSTY60IU,"Franklin, Hatfield and Wilson",Till No,0.0,240.0,572.75,Friday,2023-09-22 20:08:15
GEKIJODVHV,Mpesa Charges,Mpesa Charges,0.0,7.0,812.75,Thursday,2023-09-21 17:51:30
DSQV3HWHQR,Victoria Flores,Send Money,0.0,150.0,819.75,Thursday,2023-09-21 17:51:30
0IRVWCWH6N,"Smith, Fisher and Cruz",Till No,0.0,660.0,969.75,Thursday,2023-09-21 16:59:22
Z3KSCCKBN2,Mpesa Charges,Mpesa Charges,0.0,7.0,1629.75,Thursday,2023-09-21 11:16:00
KSXT75X2LL,Jessica Simpson,Send Money,0.0,150.0,1636.75,Thursday,2023-09-21 11:16:00
5CC2CLGWHA,"Smith, Mcknight and Brown",Till No,0.0,95.0,1786.75,Wednesday,2023-09-20 20:13:50
0TICIX7JSS,Mpesa Charges,Mpesa Charges,0.0,34.0,1881.75,Wednesday,2023-09-20 15:34:47
RO60XU4QBT,Williams and Sons,Pay Bill,0.0,4838.0,1915.75,Wednesday,2023-09-20 15:34:47
QCP0E6JIGZ,Griffith PLC,Till No,0.0,210.0,6753.75,Wednesday,2023-09-20 14:01:46
3CMFXN8XDF,Mpesa Charges,Mpesa Charges,0.0,5.0,6963.75,Wednesday,2023-09-20 09:47:53
T3CPI919K6,White-Fowler,Pay Bill,0.0,500.0,6968.75,Wednesday,2023-09-20 09:47:53
B4ODBHGEQQ,Griffith PLC,Till No,0.0,80.0,7468.75,Wednesday,2023-09-20 09:39:55
NP9PHVN44C,"Franklin, Hatfield and Wilson",Till No,0.0,200.0,7548.75,Tuesday,2023-09-19 19:52:45
29H4VTV3HT,Mpesa Charges,Mpesa Charges,0.0,15.0,7748.75,Monday,2023-09-18 19:47:41
EG8NK2YMXZ,Joyce-Ford,Pay Bill,0.0,1118.0,7763.75,Monday,2023-09-18 19:47:41
2QYH7VY79C,Garza Inc,Bank Transfer,5000.0,0.0,8881.75,Monday,2023-09-18 19:45:59
8VK4U38433,Mpesa Charges,Mpesa Charges,0.0,13.0,3881.75,Monday,2023-09-18 13:37:42
96RQBARV7I,Brian Jones,Send Money,0.0,874.0,3894.75,Monday,2023-09-18 13:37:42
EFM1BGP3EV,Lewis-Smith,Till No,0.0,330.0,4768.75,Sunday,2023-09-17 19:10:38
ERSOBAQLC2,Mpesa Charges,Mpesa Charges,0.0,25.0,5098.75,Sunday,2023-09-17 14:17:29
EMW1A5U91H,"Benitez, Palmer and Lane",Pay Bill,0.0,2619.0,5123.75,Sunday,2023-09-17 14:17:29
IIZ0IVBJVO,Jeremy Simmons,Receive Money,3020.0,0.0,7742.75,Sunday,2023-09-17 01:28:43
YVLCK86PVR,"Carlson, Curtis and Perez",Till No,0.0,3020.0,4722.75,Sunday,2023-09-17 01:27:55
6Z9EWB3HDR,"Foley, Rodriguez and Nguyen",Bank Transfer,5000.0,0.0,7742.75,Sunday,2023-09-17 01:26:51
OMJ055H44U,Combs-Morgan,Till No,0.0,1417.0,2742.75,Saturday,2023-09-16 18:35:23
VMXN9NDEJM,Moran LLC,Till No,0.0,100.0,4159.75,Saturday,2023-09-16 11:49:47
X28LRHA2KG,Mpesa Charges,Mpesa Charges,0.0,5.0,4259.75,Saturday,2023-09-16 08:39:29
TC0M31SRR5,"Barajas, Cox and Reid",Pay Bill,0.0,200.0,4264.75,Saturday,2023-09-16 08:39:29
UDNVE2U8TP,"Smith, Mcknight and Brown",Till No,0.0,40.0,4464.75,Friday,2023-09-15 20:40:15
9CKCS53SNS,"Baird, Martin and Baker",Till No,0.0,650.0,4504.75,Friday,2023-09-15 20:37:39
0CM7SGW3BL,"Harris, Terrell and Roberts",Bank Transfer,5000.0,0.0,5154.75,Friday,2023-09-15 20:27:48
SWP9EHU4PM,"Franklin, Hatfield and Wilson",Till No,0.0,140.0,154.75,Friday,2023-09-15 10:37:40
4EH7UHXS8O,Mpesa Charges,Mpesa Charges,0.0,23.0,294.75,Thursday,2023-09-14 20:42:50
XY0OTUEE1Z,Gary Holmes,Send Money,0.0,1329.0,317.75,Thursday,2023-09-14 20:42:50
RTC2WD4TNQ,"Franklin, Hatfield and Wilson",Till No,0.0,450.0,1646.75,Thursday,2023-09-14 12:55:24
805CL61AM2,Lopez LLC,Till No,0.0,400.0,2096.75,Wednesday,2023-09-13 21:17:39
9D691F9K6E,"Franklin, Hatfield and Wilson",Till No,0.0,300.0,2496.75,Wednesday,2023-09-13 14:39:18
5FWP4AX7G9,"Hill, Matthews and Martin",Till No,0.0,300.0,2796.75,Wednesday,2023-09-13 13:00:42
22J8U3TFKH,Mpesa Charges,Mpesa Charges,0.0,10.0,3096.75,Wednesday,2023-09-13 12:03:12
T457WVOWP0,Davidson-Figueroa,Pay Bill,0.0,760.0,3106.75,Wednesday,2023-09-13 12:03:12
IC8972BST9,Roy Brown,Receive Money,760.0,0.0,3866.75,Wednesday,2023-09-13 12:02:19
0EXOSFJPKK,Rebecca Hicks,Receive Money,760.0,0.0,3866.75,Wednesday,2023-09-13 12:02:19
LS2IEULE85,Mpesa Charges,Mpesa Charges,0.0,5.0,3106.75,Wednesday,2023-09-13 08:50:46
X8MOMDEM3E,White-Fowler,Pay Bill,0.0,500.0,3111.75,Wednesday,2023-09-13 08:50:46
GQXEUD5OVQ,"Franklin, Hatfield and Wilson",Till No,0.0,200.0,3611.75,Tuesday,2023-09-12 20:00:44
6ZP67800MI,"Franklin, Hatfield and Wilson",Till No,0.0,170.0,3811.75,Tuesday,2023-09-12 13:49:00
A9FXNZEM71,Alicia Chapman,Send Money,0.0,30.0,3981.75,Monday,2023-09-11 18:44:30
1WNDUIHNPT,Sanders-Castillo,Till No,0.0,180.0,4011.75,Monday,2023-09-11 18:41:21
QUA7JNMSER,Mpesa Charges,Mpesa Charges,0.0,15.0,4191.75,Monday,2023-09-11 17:21:12
JFDON3CWFP,Edwards and Sons,Pay Bill,0.0,1500.0,4206.75,Monday,2023-09-11 17:21:12
5RUJ8GVXXN,Santos PLC,Bank Transfer,4534.0,0.0,5706.75,Monday,2023-09-11 15:00:23
HVOE6BAWEQ,Mpesa Charges,Mpesa Charges,0.0,7.0,1172.75,Monday,2023-09-11 14:57:28
QC7FF6VOIF,Donna Jones,Send Money,0.0,500.0,1179.75,Monday,2023-09-11 14:57:28
F6A8LZ0J2R,Mpesa Charges,Mpesa Charges,0.0,34.0,1679.75,Monday,2023-09-11 14:57:03
7V5EWISL9J,Yates-Dunn,Pay Bill,0.0,4000.0,1713.75,Monday,2023-09-11 14:57:03
FVIJXFQ0C1,"Schneider, Henderson and Daniel",Till No,0.0,500.0,5713.75,Sunday,2023-09-10 19:31:47
BSULUXDCJU,Mpesa Charges,Mpesa Charges,0.0,10.0,6213.75,Saturday,2023-09-09 22:26:17
YUP0L6C47R,Lewis PLC,Pay Bill,0.0,1000.0,6223.75,Saturday,2023-09-09 22:26:17
RNXD5GNG9B,"Smith, Mcknight and Brown",Till No,0.0,100.0,7223.75,Saturday,2023-09-09 18:49:58
J1SLNF2IH8,Jones Inc,Till No,0.0,475.0,7323.75,Saturday,2023-09-09 10:55:43
7D5IOLXIRH,Mayo-Yates,Pay Bill,0.0,100.0,7798.75,Saturday,2023-09-09 08:00:39
H1UVX0T18F,Kara Thompson,Pochi,0.0,30.0,7898.75,Saturday,2023-09-09 07:56:56
BR5A0Y45YM,Andrew Rhodes,Send Money,0.0,30.0,7928.75,Saturday,2023-09-09 07:48:45
G0GULX0RR9,"Smith, Mcknight and Brown",Till No,0.0,80.0,7958.75,Friday,2023-09-08 20:07:33
9MI23SOIOP,Mpesa Charges,Mpesa Charges,0.0,18.0,8038.75,Friday,2023-09-08 13:44:12
RDPAE5UUAG,Hernandez-Hawkins,Pay Bill,0.0,11404.0,8056.75,Friday,2023-09-08 13:44:12
F3BXOIIJCB,"Franklin, Hatfield and Wilson",Till No,0.0,180.0,19460.75,Friday,2023-09-08 12:48:15
I3S4PWF1WS,Patrick Ltd,Till No,0.0,400.0,19640.75,Friday,2023-09-08 12:45:09
0TZ6P2L501,Eric Smith,Send Money,0.0,40.0,20040.75,Friday,2023-09-08 11:32:25
WOB5YYIICQ,Mpesa Charges,Mpesa Charges,0.0,33.0,20080.75,Friday,2023-09-08 11:31:06
FYBOEE2ATO,Daniel Johnson,Send Money,0.0,2000.0,20113.75,Friday,2023-09-08 11:31:06
6JLEWGM8PS,Ward and Sons,Bank Transfer,22000.0,0.0,22113.75,Friday,2023-09-08 11:29:41
MOLHJH5TXU,Heather Garcia,Send Money,0.0,50.0,113.75,Friday,2023-09-08 10:54:59
QK3BCYJXRA,Mpesa Charges,Mpesa Charges,0.0,83.0,163.75,Wednesday,2023-09-06 10:28:22
Q1C4EZKN9D,"Caldwell, King and Taylor",Pay Bill,0.0,31300.0,246.75,Wednesday,2023-09-06 10:28:22
ZH4AKT5MQL,Shwari Withdraw,Mshwari Withdraw,22500.0,0.0,31546.75,Wednesday,2023-09-06 10:25:34
OCAT581KZW,Klein PLC,Bank Transfer,5900.0,0.0,9046.75,Wednesday,2023-09-06 10:24:44
A3ZQRBIRDF,Mpesa Charges,Mpesa Charges,0.0,7.0,3146.75,Wednesday,2023-09-06 08:20:43
ZYWYJTAMH2,Kaitlyn Davis,Send Money,0.0,270.0,3153.75,Wednesday,2023-09-06 08:20:43
G6XVNCTJBF,"Carlson, Smith and Thomas",Till No,0.0,15.0,3423.75,Wednesday,2023-09-06 07:51:57
60MGWGY75O,"Carlson, Smith and Thomas",Till No,0.0,312.0,3438.75,Wednesday,2023-09-06 07:50:14
E94O8RLPVG,Mpesa Charges,Mpesa Charges,0.0,7.0,3750.75,Wednesday,2023-09-06 07:32:00
TVFAXJB51X,Scott Griffin,Pochi,0.0,200.0,3757.75,Wednesday,2023-09-06 07:32:00
Y1TF5GFCCZ,"Randolph, Roberson and Gonzalez",Till No,0.0,2630.0,3957.75,Tuesday,2023-09-05 21:09:01
HARKXSAQR9,Shwari Withdraw,Mshwari Withdraw,5000.0,0.0,6587.75,Tuesday,2023-09-05 21:06:28
8YGMV1L7Q4,Mpesa Charges,Mpesa Charges,0.0,7.0,1587.75,Tuesday,2023-09-05 19:26:29
2OFQ90C44T,Marissa Simon,Send Money,0.0,500.0,1594.75,Tuesday,2023-09-05 19:26:29
B3O8OW2O4W,Mpesa Charges,Mpesa Charges,0.0,13.0,2094.75,Tuesday,2023-09-05 18:33:31
WQAJVVFYBS,Stacey Costa,Send Money,0.0,800.0,2107.75,Tuesday,2023-09-05 18:33:31
EVXFCXIIMF,Mpesa Charges,Mpesa Charges,0.0,5.0,2907.75,Tuesday,2023-09-05 11:45:58
RIKKT1WBV9,White-Fowler,Pay Bill,0.0,500.0,2912.75,Tuesday,2023-09-05 11:45:58
D323VSRSGX,"Smith, Mcknight and Brown",Till No,0.0,80.0,3412.75,Monday,2023-09-04 19:29:07
MN5J12VHUP,Wells-Day,Till No,0.0,50.0,3492.75,Sunday,2023-09-03 18:06:50
DJLN0DPKFA,"Johnson, Craig and Garcia",Till No,0.0,254.0,3542.75,Sunday,2023-09-03 18:05:02
SU87GL88WZ,Mpesa Charges,Mpesa Charges,0.0,7.0,3796.75,Sunday,2023-09-03 17:33:24
98BC6WOA80,Steven Sosa,Send Money,0.0,120.0,3803.75,Sunday,2023-09-03 17:33:24
AQ2CDXF77W,"Armstrong, Price and Ortiz",Till No,0.0,2130.0,3923.75,Sunday,2023-09-03 16:39:57
HOE14HLBL4,Mpesa Charges,Mpesa Charges,0.0,7.0,6053.75,Sunday,2023-09-03 11:59:47
CNVZ2PTWGO,Evan Rivera,Send Money,0.0,140.0,6060.75,Sunday,2023-09-03 11:59:47
10J3S51J3V,Smith-Lane,Till No,0.0,800.0,6200.75,Saturday,2023-09-02 18:38:12
3XVH9EAP52,Samantha Walters,Send Money,0.0,100.0,7000.75,Saturday,2023-09-02 17:54:09
YOWYWYBDES,Airtime Purchase,Airtime Purchase,0.0,500.0,7100.75,Saturday,2023-09-02 12:34:23
4QGXTT2YMW,Sonya Greene,Send Money,0.0,65.0,7600.75,Saturday,2023-09-02 09:50:27
Q10COHSD72,Mpesa Charges,Mpesa Charges,0.0,7.0,7665.75,Friday,2023-09-01 19:33:48
42ZSYNA8IJ,Nicole Carrillo,Send Money,0.0,240.0,7672.75,Friday,2023-09-01 19:33:48
M217E5P6EF,"Keith, Phillips and Singleton",Pay Bill,0.0,4100.0,7912.75,Friday,2023-09-01 08:11:04
N670UDOE4D,Other,Other,0.0,1000.0,12012.75,Friday,2023-09-01 08:09:17
BHDXY3CWXS,Shwari Withdraw,Mshwari Withdraw,10000.0,0.0,13012.75,Friday,2023-09-01 08:06:47
YGEPWZBGX2,Mpesa Charges,Mpesa Charges,0.0,33.0,3012.75,Thursday,2023-08-31 20:53:17
F70WNS748R,Katie Valdez,Send Money,0.0,1776.0,3045.75,Thursday,2023-08-31 20:53:17
6SF0IITRB3,Mpesa Charges,Mpesa Charges,0.0,23.0,4821.75,Thursday,2023-08-31 15:54:02
DWI7UQGTGV,Joseph Evans,Send Money,0.0,1244.0,4844.75,Thursday,2023-08-31 15:54:02
OMSJJJB9Y4,Shwari Withdraw,Mshwari Withdraw,5000.0,0.0,6088.75,Thursday,2023-08-31 15:53:29
I8CUO7TM10,"Hill, Matthews and Martin",Till No,0.0,300.0,1088.75,Thursday,2023-08-31 12:18:34
01R6XRNY10,Mpesa Charges,Mpesa Charges,0.0,13.0,1388.75,Wednesday,2023-08-30 19:03:16
16O7AY81ZZ,Michelle Lewis,Send Money,0.0,610.0,1401.75,Wednesday,2023-08-30 19:03:16
SUXML7WM3E,Miller-Gallagher,Till No,0.0,550.0,2011.75,Wednesday,2023-08-30 18:08:44
UICDWVZQR1,"Stanley, Potter and Morales",Till No,0.0,65.0,2561.75,Wednesday,2023-08-30 16:17:06
DPDW8RJLWD,Krueger-Best,Till No,0.0,10.0,2626.75,Wednesday,2023-08-30 15:38:19
HWZLBPFM08,Mpesa Charges,Mpesa Charges,0.0,33.0,2636.75,Wednesday,2023-08-30 15:34:04
TVXJSNKTLH,Katherine Mclaughlin,Send Money,0.0,1710.0,2669.75,Wednesday,2023-08-30 15:34:04
TM561MIT87,Mayo-Yates,Pay Bill,0.0,100.0,4379.75,Wednesday,2023-08-30 08:45:49
OO3TGRWR7A,Mpesa Charges,Mpesa Charges,0.0,7.0,4479.75,Wednesday,2023-08-30 08:43:40
IPKZGLLJR1,Sylvia Wilson,Send Money,0.0,290.0,4486.75,Wednesday,2023-08-30 08:43:40
79GUI067HY,Mpesa Charges,Mpesa Charges,0.0,23.0,4776.75,Tuesday,2023-08-29 19:36:10
XTR4J07568,Andrew Weaver,Send Money,0.0,1390.0,4799.75,Tuesday,2023-08-29 19:36:10
M0R6M7V6R9,Mpesa Charges,Mpesa Charges,0.0,25.0,6189.75,Tuesday,2023-08-29 15:46:31
ZFCT90IL0Y,Howard Inc,Pay Bill,0.0,3000.0,6214.75,Tuesday,2023-08-29 15:46:31
NTWDZDAS9I,Mpesa Charges,Mpesa Charges,0.0,23.0,9214.75,Tuesday,2023-08-29 09:14:57
ORJCHUS86H,Stacy Myers,Send Money,0.0,1300.0,9237.75,Tuesday,2023-08-29 09:14:57
AENQXEPBNM,Mpesa Charges,Mpesa Charges,0.0,13.0,10537.75,Monday,2023-08-28 19:13:31
VSWE5F1NYH,Hayley Williams,Send Money,0.0,1000.0,10550.75,Monday,2023-08-28 19:13:31
58L5CRJEVF,Mpesa Charges,Mpesa Charges,0.0,5.0,11550.75,Monday,2023-08-28 17:56:44
NE1C6QRHUG,White-Fowler,Pay Bill,0.0,500.0,11555.75,Monday,2023-08-28 17:56:44
ZFOC0F4F87,"Johnson, Craig and Garcia",Till No,0.0,65.0,12055.75,Monday,2023-08-28 09:48:45
OJJ07OX7TH,"Smith, Mcknight and Brown",Till No,0.0,85.0,12120.75,Sunday,2023-08-27 15:44:36
XCVQCPIM2F,Mpesa Charges,Mpesa Charges,0.0,34.0,12205.75,Sunday,2023-08-27 10:02:43
RYU4NP13VB,Williams and Sons,Pay Bill,0.0,3510.0,12239.75,Sunday,2023-08-27 10:02:43
WWAC3G2U9F,"Willis, Lopez and Spencer",Till No,0.0,500.0,15749.75,Saturday,2023-08-26 19:28:09
JJMA5YEGPB,Mpesa Charges,Mpesa Charges,0.0,57.0,16249.75,Saturday,2023-08-26 19:00:58
44KTJ8MTZX,"Bridges, Blackwell and Meyer",Pay Bill,0.0,12000.0,16306.75,Saturday,2023-08-26 19:00:58
LL1J1C93RD,Shwari Withdraw,Mshwari Withdraw,20000.0,0.0,28306.75,Saturday,2023-08-26 19:00:19
33KFZBSKTT,Michelle Gill,Send Money,0.0,50.0,8306.75,Saturday,2023-08-26 13:07:02
GCUKUVPUJK,"Gomez, Rice and Simpson",Till No,0.0,218.0,8356.75,Saturday,2023-08-26 12:50:02
SDG263MSUX,"Ellison, Douglas and Phelps",Pay Bill,0.0,100.0,8574.75,Saturday,2023-08-26 10:38:03
R4IVBTS833,Kelsey Potter,Receive Money,2700.0,0.0,8674.75,Saturday,2023-08-26 08:53:33
A0MIGJQ6YP,Charlotte Davis,Receive Money,2700.0,0.0,8674.75,Saturday,2023-08-26 08:53:33
HSDIV7PRMG,"Willis, Lopez and Spencer",Till No,0.0,200.0,5974.75,Friday,2023-08-25 20:31:22
LUAQ5S8M81,Ochoa LLC,Till No,0.0,140.0,6174.75,Friday,2023-08-25 09:44:00
LJHXL46I5P,Mpesa Charges,Mpesa Charges,0.0,7.0,6314.75,Thursday,2023-08-24 23:09:24
NBBTNY5ACY,Evan Moon,Send Money,0.0,430.0,6321.75,Thursday,2023-08-24 23:09:24
6ZTA6M7ZNW,"Robertson, Schneider and Jimenez",Till No,0.0,1074.0,6751.75,Thursday,2023-08-24 16:38:29
C8MCSPER79,"Smith, Mcknight and Brown",Till No,0.0,90.0,7825.75,Wednesday,2023-08-23 19:55:27
I7WFH5TNGR,Austin Velez,Send Money,0.0,100.0,7915.75,Wednesday,2023-08-23 19:51:11
STMU49CW87,Reeves-Copeland,Till No,0.0,1698.0,8015.75,Wednesday,2023-08-23 19:34:26
VCPX0DVAOK,Mpesa Charges,Mpesa Charges,0.0,13.0,9713.75,Wednesday,2023-08-23 18:49:48
AOVYMMXHZT,Katherine Deleon,Send Money,0.0,1000.0,9726.75,Wednesday,2023-08-23 18:49:48
M89KTRS8DJ,Mpesa Charges,Mpesa Charges,0.0,108.0,10726.75,Wednesday,2023-08-23 18:44:04
AKUTA1N56J,Gordon and Sons,Pay Bill,0.0,69000.0,10834.75,Wednesday,2023-08-23 18:44:04
YAVLHTIBP7,Shwari Withdraw,Mshwari Withdraw,69500.0,0.0,79834.75,Wednesday,2023-08-23 18:40:11
3JAX2Q4X5X,Turner-Ross,Till No,0.0,2000.0,10334.75,Wednesday,2023-08-23 18:22:59
VYRLDMOKGV,Mark Dickson,Send Money,0.0,100.0,12334.75,Wednesday,2023-08-23 18:12:56
SY3NSN5X2Q,Stacey Fletcher,Receive Money,7000.0,0.0,12434.75,Wednesday,2023-08-23 17:02:26
XYGBYK8XWC,"Anderson, Thompson and Rogers",Till No,0.0,900.0,5434.75,Tuesday,2023-08-22 19:47:22
FHJ4YRGYJE,Mcgee-Palmer,Till No,0.0,205.0,6334.75,Tuesday,2023-08-22 19:28:31
WYZZAJ11GC,Mpesa Charges,Mpesa Charges,0.0,33.0,6539.75,Tuesday,2023-08-22 17:26:53
R44Z7MI321,Kelsey Potter,Send Money,0.0,2500.0,6572.75,Tuesday,2023-08-22 17:26:53
9IO4C2TBOO,Charlotte Davis,Send Money,0.0,2500.0,6572.75,Tuesday,2023-08-22 17:26:53
P6H0BBGHNB,Mpesa Charges,Mpesa Charges,0.0,20.0,9072.75,Monday,2023-08-21 16:32:32
0R0U9IMNV6,"Benitez, Palmer and Lane",Pay Bill,0.0,1939.0,9092.75,Monday,2023-08-21 16:32:32
J2190CCSJ4,Shwari Withdraw,Mshwari Withdraw,10000.0,0.0,11031.75,Monday,2023-08-21 16:30:14
5SAWRFALHA,Michael Sanchez,Send Money,0.0,40.0,1031.75,Sunday,2023-08-20 19:23:10
JMGXCZZ7TK,Mpesa Charges,Mpesa Charges,0.0,5.0,1071.75,Sunday,2023-08-20 16:42:12
3FO4WIL709,White-Fowler,Pay Bill,0.0,500.0,1076.75,Sunday,2023-08-20 16:42:12
8B69TUZXK5,Michael Sanchez,Send Money,0.0,100.0,1576.75,Saturday,2023-08-19 19:59:35
PFRG7S6RPM,"Hill, Matthews and Martin",Till No,0.0,300.0,1676.75,Saturday,2023-08-19 18:50:53
UYVQODWJZZ,Mpesa Charges,Mpesa Charges,0.0,13.0,1976.75,Saturday,2023-08-19 16:44:53
YYX9PVJDN6,Shawn Wise III,Send Money,0.0,610.0,1989.75,Saturday,2023-08-19 16:44:53
PEH7SNVEL4,"Carlson, Smith and Thomas",Till No,0.0,1882.0,2599.75,Saturday,2023-08-19 16:16:09
H8F8WE5R6S,Mpesa Charges,Mpesa Charges,0.0,5.0,4481.75,Saturday,2023-08-19 09:02:49
ZLT1ZE6H7G,"Ramirez, Davis and Smith",Pay Bill,0.0,120.0,4486.75,Saturday,2023-08-19 09:02:49
TR9CH84HQK,Mpesa Charges,Mpesa Charges,0.0,33.0,4606.75,Saturday,2023-08-19 08:38:20
N5U2SQDU5E,Haley Graham,Send Money,0.0,1800.0,4639.75,Saturday,2023-08-19 08:38:20
KJ995S8K9W,Mpesa Charges,Mpesa Charges,0.0,10.0,6439.75,Saturday,2023-08-19 06:33:18
QM9UAF9WRS,Mitchell LLC,Pay Bill,0.0,730.0,6449.75,Saturday,2023-08-19 06:33:18
ACXY4C2K4H,Wells-Day,Till No,0.0,50.0,7179.75,Friday,2023-08-18 20:21:26
RRPRWCZAO4,"Johnson, Craig and Garcia",Till No,0.0,65.0,7229.75,Friday,2023-08-18 20:20:44
CPMIOZAE6T,Laurie Armstrong,Send Money,0.0,40.0,7294.75,Friday,2023-08-18 20:18:43
ST130JQTUU,Mpesa Charges,Mpesa Charges,0.0,7.0,7334.75,Friday,2023-08-18 20:17:16
16OITDIA4U,Michael Sanchez,Send Money,0.0,160.0,7341.75,Friday,2023-08-18 20:17:16
OIMYK94SSG,Michael Kim,Send Money,0.0,100.0,7501.75,Friday,2023-08-18 20:13:58
9834XD70Y9,Mpesa Charges,Mpesa Charges,0.0,7.0,7601.75,Friday,2023-08-18 20:13:31
H9F921EV74,Samantha Walters,Send Money,0.0,350.0,7608.75,Friday,2023-08-18 20:13:31
O9WBIE8VOE,Palmer LLC,Till No,0.0,4000.0,7958.75,Friday,2023-08-18 14:32:21
D01PFXPUDQ,Shwari Withdraw,Mshwari Withdraw,10000.0,0.0,11958.75,Friday,2023-08-18 14:04:07
ZOB53ZAQX7,Morgan Pugh,Send Money,0.0,100.0,1958.75,Thursday,2023-08-17 18:59:47
PQ2AI9VVK5,Morgan Pugh,Send Money,0.0,60.0,2058.75,Thursday,2023-08-17 18:59:15
DZVG6W9KLL,"Wiley, Green and Scott",Till No,0.0,2490.0,2118.75,Thursday,2023-08-17 16:35:57
3UV3638TJP,Joseph Perez,Receive Money,800.0,0.0,4608.75,Thursday,2023-08-17 16:02:09
20FGUGQ5V0,Dorothy Price,Receive Money,800.0,0.0,4608.75,Thursday,2023-08-17 16:02:09
V98G98I7S0,Mark Dickson,Send Money,0.0,80.0,3808.75,Thursday,2023-08-17 15:31:39
8RXDEN30VX,Mpesa Charges,Mpesa Charges,0.0,20.0,3888.75,Thursday,2023-08-17 10:37:30
S6A6QZEWRN,Long LLC,Pay Bill,0.0,2000.0,3908.75,Thursday,2023-08-17 10:37:30
F6UPV5HWIC,Shwari Withdraw,Mshwari Withdraw,5000.0,0.0,5908.75,Thursday,2023-08-17 10:31:50
E1EA58VQCC,Ochoa LLC,Till No,0.0,65.0,908.75,Thursday,2023-08-17 09:39:33
VPY4ESGHXV,Brown-Anderson,Till No,0.0,480.0,973.75,Wednesday,2023-08-16 19:23:10
ZE1QOPBAEQ,Virginia Howard,Pochi,0.0,40.0,1453.75,Wednesday,2023-08-16 18:32:52
AUJ72VMA53,Kim-Everett,Till No,0.0,60.0,1493.75,Wednesday,2023-08-16 18:29:06
7JEGCF81NS,Mpesa Charges,Mpesa Charges,0.0,7.0,1553.75,Tuesday,2023-08-15 19:11:44
XQUBCSOD1R,Michael Sanchez,Send Money,0.0,140.0,1560.75,Tuesday,2023-08-15 19:11:44
8W4Q65FLHA,Alicia Chapman,Send Money,0.0,30.0,1700.75,Tuesday,2023-08-15 19:08:36
PSCYOK7GFU,Mpesa Charges,Mpesa Charges,0.0,13.0,1730.75,Tuesday,2023-08-15 18:44:27
Y3S89BBFRM,Stacey Costa,Send Money,0.0,1000.0,1743.75,Tuesday,2023-08-15 18:44:27
SB4QL7KNNJ,Other,Other,0.0,1000.0,2743.75,Tuesday,2023-08-15 15:36:33
5H59N56BH3,Mpesa Charges,Mpesa Charges,0.0,5.0,3743.75,Monday,2023-08-14 21:04:56
5T1Y39WAPG,White-Fowler,Pay Bill,0.0,500.0,3748.75,Monday,2023-08-14 21:04:56
4X9OC2QDH4,Alicia Chapman,Send Money,0.0,30.0,4248.75,Monday,2023-08-14 18:53:44
5UBTM0GNM2,Tracy Harrison,Pochi,0.0,70.0,4278.75,Sunday,2023-08-13 21:44:27
9COC7G85KG,Patrick Johnson,Pochi,0.0,50.0,4348.75,Sunday,2023-08-13 11:55:40
A8316V3MRB,Mark Brown,Send Money,0.0,50.0,4398.75,Sunday,2023-08-13 11:45:00
KA9L2ZIS1Q,Mpesa Charges,Mpesa Charges,0.0,7.0,4448.75,Sunday,2023-08-13 09:45:13
VZA5PO204D,Samantha Walters,Send Money,0.0,500.0,4455.75,Sunday,2023-08-13 09:45:13
98HYVGJOMG,Mpesa Charges,Mpesa Charges,0.0,7.0,4955.75,Saturday,2023-08-12 19:56:03
2Q2O7VRKD9,Michael Sanchez,Send Money,0.0,165.0,4962.75,Saturday,2023-08-12 19:56:03
WXLPHQZSBD,Shwari Withdraw,Mshwari Withdraw,5000.0,0.0,5127.75,Saturday,2023-08-12 19:55:33
M2D8OR5AFE,Annette Hines,Send Money,0.0,100.0,127.75,Saturday,2023-08-12 14:39:23
0PJXVZGT8C,"Gomez, Rice and Simpson",Till No,0.0,2643.0,227.75,Saturday,2023-08-12 14:33:20
9GO7UKGQQB,Mpesa Charges,Mpesa Charges,0.0,10.0,2870.75,Saturday,2023-08-12 11:06:22
NUG1KRMQT2,Taylor-Robbins,Pay Bill,0.0,1000.0,2880.75,Saturday,2023-08-12 11:06:22
16ADA591WS,Mpesa Charges,Mpesa Charges,0.0,5.0,3880.75,Saturday,2023-08-12 10:33:59
SNRAWYQFA1,"Barajas, Cox and Reid",Pay Bill,0.0,200.0,3885.75,Saturday,2023-08-12 10:33:59
MJ7IX3S35R,"Ho, Howell and Welch",Till No,0.0,250.0,4085.75,Friday,2023-08-11 21:16:31
EPTRK48PAJ,"Johnson, Craig and Garcia",Till No,0.0,255.0,4335.75,Friday,2023-08-11 21:12:54
WW2U2JGPO4,Wells-Day,Till No,0.0,900.0,4590.75,Friday,2023-08-11 21:11:39
T31FWSPT9W,Mpesa Charges,Mpesa Charges,0.0,20.0,5490.75,Friday,2023-08-11 21:04:25
C2MJJLSQOQ,Berger-Young,Pay Bill,0.0,1729.0,5510.75,Friday,2023-08-11 21:04:25
06YHDEXM90,Martinez-Walsh,Till No,0.0,240.0,7239.75,Friday,2023-08-11 16:16:15
BC88J27HA2,Michael Sanchez,Send Money,0.0,90.0,7479.75,Thursday,2023-08-10 19:53:42
X3Z3PV9TVH,Martinez-Walsh,Till No,0.0,30.0,7569.75,Thursday,2023-08-10 10:07:41
C5T68SQC2H,"Hill, Matthews and Martin",Till No,0.0,300.0,7599.75,Wednesday,2023-08-09 18:27:54
5SYUEKF3ME,Mpesa Charges,Mpesa Charges,0.0,23.0,7899.75,Wednesday,2023-08-09 17:53:50
KCLNN55RDP,Eric Duran,Send Money,0.0,1319.0,7922.75,Wednesday,2023-08-09 17:53:50
OULJ3KH69H,Mpesa Charges,Mpesa Charges,0.0,7.0,9241.75,Tuesday,2023-08-08 19:02:48
Q1AALLSMJK,Michael Sanchez,Send Money,0.0,150.0,9248.75,Tuesday,2023-08-08 19:02:48
PQRV7CM5OK,Mpesa Charges,Mpesa Charges,0.0,10.0,9398.75,Monday,2023-08-07 20:52:36
8JBUS17XAE,Davidson-Figueroa,Pay Bill,0.0,760.0,9408.75,Monday,2023-08-07 20:52:36
FR8Y2GWL7R,Shwari Withdraw,Mshwari Withdraw,10000.0,0.0,10168.75,Monday,2023-08-07 20:51:06
YY2QDWCS8X,Mpesa Charges,Mpesa Charges,0.0,5.0,168.75,Monday,2023-08-07 19:16:49
8QT1IF82XM,White-Fowler,Pay Bill,0.0,500.0,173.75,Monday,2023-08-07 19:16:49
JTXLT7OFQ7,Mpesa Charges,Mpesa Charges,0.0,33.0,673.75,Sunday,2023-08-06 15:50:50
A1ORS4FKIT,Veronica Richardson,Send Money,0.0,1574.0,706.75,Sunday,2023-08-06 15:50:50
P7WSLMEFUA,Mpesa Charges,Mpesa Charges,0.0,83.0,2280.75,Saturday,2023-08-05 18:48:21
IA02HCYZLK,"Caldwell, King and Taylor",Pay Bill,0.0,31300.0,2363.75,Saturday,2023-08-05 18:48:21
Q71D9W6JTP,Shwari Withdraw,Mshwari Withdraw,30000.0,0.0,33663.75,Saturday,2023-08-05 18:47:29
QKBV4LW5ER,"Carlson, Smith and Thomas",Till No,0.0,218.0,3663.75,Saturday,2023-08-05 16:43:45
ZPX6LJZWRH,Mpesa Charges,Mpesa Charges,0.0,7.0,3881.75,Saturday,2023-08-05 15:31:30
I0VAO3GRWR,Hector Kramer,Send Money,0.0,350.0,3888.75,Saturday,2023-08-05 15:31:30
WK1GFPJJ64,Theresa Kelly,Send Money,0.0,350.0,3888.75,Saturday,2023-08-05 15:31:30
KP4CSP6G0Z,Wilcox and Sons,Till No,0.0,400.0,4238.75,Saturday,2023-08-05 14:35:21
9HQK7KE3XG,Wilcox and Sons,Till No,0.0,340.0,4638.75,Saturday,2023-08-05 08:51:51
V6U76KQRPL,Mpesa Charges,Mpesa Charges,0.0,13.0,4978.75,Saturday,2023-08-05 07:14:17
HQHY3HOL1H,Joseph Perez,Send Money,0.0,720.0,4991.75,Saturday,2023-08-05 07:14:17
UC2MC0AU6U,Michael Sanchez,Send Money,0.0,100.0,5711.75,Friday,2023-08-04 19:11:39
EIMDQAXD27,Airtime Purchase,Airtime Purchase,0.0,500.0,5811.75,Friday,2023-08-04 08:49:39
4ZV3W8MW14,Mpesa Charges,Mpesa Charges,0.0,33.0,6311.75,Friday,2023-08-04 08:47:09
FRUPKC0O3P,Hector Kramer,Send Money,0.0,2500.0,6344.75,Friday,2023-08-04 08:47:09
VYN5GBJVGT,Theresa Kelly,Send Money,0.0,2500.0,6344.75,Friday,2023-08-04 08:47:09
GXXCH54S7Q,Mpesa Charges,Mpesa Charges,0.0,7.0,8844.75,Thursday,2023-08-03 20:39:58
FPUR7TEWJ3,Benjamin Villanueva,Send Money,0.0,280.0,8851.75,Thursday,2023-08-03 20:39:58
OAMWVDCENS,Mpesa Charges,Mpesa Charges,0.0,15.0,9131.75,Thursday,2023-08-03 17:54:48
2LVVP0T4Y9,"Bridges, Blackwell and Meyer",Pay Bill,0.0,1500.0,9146.75,Thursday,2023-08-03 17:54:48
YA1QL66FE7,John Roberson,Send Money,0.0,40.0,10646.75,Wednesday,2023-08-02 19:55:40
DFMPHWYKPO,Jennifer Hernandez,Send Money,0.0,50.0,10686.75,Wednesday,2023-08-02 19:53:33
7G9F7WY5SE,Mpesa Charges,Mpesa Charges,0.0,42.0,10736.75,Wednesday,2023-08-02 13:54:52
2ZYVY6JZHA,Schultz-Keller,Pay Bill,0.0,6981.0,10778.75,Wednesday,2023-08-02 13:54:52
7RSOD33LH3,Mpesa Charges,Mpesa Charges,0.0,7.0,17759.75,Tuesday,2023-08-01 18:48:41
DC2LVRMP50,Benjamin Villanueva,Send Money,0.0,160.0,17766.75,Tuesday,2023-08-01 18:48:41
IU5O9F61CG,Benjamin Villanueva,Send Money,0.0,60.0,17926.75,Tuesday,2023-08-01 17:43:34
3F2GPX8K9F,Mpesa Charges,Mpesa Charges,0.0,23.0,2151.75,Monday,2023-07-31 20:36:08
CPI7C8YRBD,Javier Moore,Send Money,0.0,1449.0,2174.75,Monday,2023-07-31 20:36:08
C5MF7EV4JO,Mpesa Charges,Mpesa Charges,0.0,5.0,3623.75,Sunday,2023-07-30 20:40:12
08261UNSCI,White-Fowler,Pay Bill,0.0,500.0,3628.75,Sunday,2023-07-30 20:40:12
S8TBHWS53F,Mpesa Charges,Mpesa Charges,0.0,33.0,4128.75,Sunday,2023-07-30 19:16:40
4Y6NW5D7JP,Curtis Murray,Send Money,0.0,2300.0,4161.75,Sunday,2023-07-30 19:16:40
N2JW84Q0ZR,Shwari Withdraw,Mshwari Withdraw,5000.0,0.0,6461.75,Sunday,2023-07-30 19:14:44
NMQK1G0LEK,Mpesa Charges,Mpesa Charges,0.0,13.0,1461.75,Sunday,2023-07-30 12:28:33
1CR1H6Q4JU,Hector Kramer,Send Money,0.0,1000.0,1474.75,Sunday,2023-07-30 12:28:33
95U94R7Z6G,Theresa Kelly,Send Money,0.0,1000.0,1474.75,Sunday,2023-07-30 12:28:33
XJAKAEFI1G,"Frazier, Howell and Snyder",Till No,0.0,210.0,2474.75,Sunday,2023-07-30 12:18:42
SC7S3RR8CC,Joseph Crawford,Send Money,0.0,50.0,2684.75,Saturday,2023-07-29 21:46:13
UFQ87XAMDJ,"Gomez, Rice and Simpson",Till No,0.0,1596.0,2734.75,Saturday,2023-07-29 21:40:10
NWYZKHPIYE,Marie Kim,Send Money,0.0,60.0,4330.75,Saturday,2023-07-29 21:01:14
JKYKZR1FCX,Mpesa Charges,Mpesa Charges,0.0,13.0,4390.75,Saturday,2023-07-29 18:22:16
L343ON8FGK,David Wagner,Send Money,0.0,800.0,4403.75,Saturday,2023-07-29 18:22:16
YHWBCDUPVK,Shwari Withdraw,Mshwari Withdraw,5000.0,0.0,5203.75,Saturday,2023-07-29 18:13:09
548I0O3VXK,Mpesa Charges,Mpesa Charges,0.0,13.0,203.75,Saturday,2023-07-29 03:45:07
7ZIBB4BEDA,Hector Kramer,Send Money,0.0,600.0,216.75,Saturday,2023-07-29 03:45:07
W9R1S4AN94,Theresa Kelly,Send Money,0.0,600.0,216.75,Saturday,2023-07-29 03:45:07
R2ENLO3H4X,Mpesa Charges,Mpesa Charges,0.0,6.0,816.75,Thursday,2023-07-27 20:48:33
ZJCCEPCU3R,Sonya Greene,Send Money,0.0,140.0,822.75,Thursday,2023-07-27 20:48:33
F9INLBFGOR,Payne and Sons,Till No,0.0,65.0,962.75,Thursday,2023-07-27 08:16:09
0MRNENEWW7,Michael Sanchez,Send Money,0.0,50.0,1027.75,Wednesday,2023-07-26 19:14:22
XZY632SU9O,Jennifer Hernandez,Send Money,0.0,90.0,1077.75,Wednesday,2023-07-26 19:12:40
HQU9NV7L3N,Edwards and Sons,Pay Bill,0.0,100.0,1167.75,Wednesday,2023-07-26 16:54:15
TNX1H2DVE2,Mpesa Charges,Mpesa Charges,0.0,32.0,1267.75,Tuesday,2023-07-25 18:34:36
NXNM6T4PP4,David Montoya,Send Money,0.0,2174.0,1299.75,Tuesday,2023-07-25 18:34:36
2NTNSJ3J2P,Nichols LLC,Till No,0.0,1800.0,3473.75,Tuesday,2023-07-25 16:03:45
V3KIP16FQJ,Shwari Withdraw,Mshwari Withdraw,5000.0,0.0,5273.75,Tuesday,2023-07-25 16:02:29
2KKL59P38A,Mpesa Charges,Mpesa Charges,0.0,19.0,273.75,Tuesday,2023-07-25 16:00:02
H1DBBR1MFQ,Cortez Ltd,Pay Bill,0.0,1600.0,292.75,Tuesday,2023-07-25 16:00:02
TND8R72FQD,"Hill, Matthews and Martin",Till No,0.0,300.0,1892.75,Tuesday,2023-07-25 13:20:18
34GG7OQ6JG,Tanner Mitchell,Send Money,0.0,80.0,2192.75,Monday,2023-07-24 18:32:55
7B0GEQAXED,Mpesa Charges,Mpesa Charges,0.0,4.0,2272.75,Monday,2023-07-24 13:23:10
OBX851DYJW,Newman Inc,Pay Bill,0.0,500.0,2276.75,Monday,2023-07-24 13:23:10
83LE2FH93Y,Mpesa Charges,Mpesa Charges,0.0,6.0,2776.75,Sunday,2023-07-23 19:36:02
Z593PVDZ35,Michael Sanchez,Send Money,0.0,190.0,2782.75,Sunday,2023-07-23 19:36:02
9SNS2DXIBR,Moran LLC,Till No,0.0,100.0,2972.75,Sunday,2023-07-23 11:05:05
VHMI67N1GO,Mpesa Charges,Mpesa Charges,0.0,12.0,3072.75,Saturday,2023-07-22 19:38:13
ROMT0QU1JI,John Gutierrez,Send Money,0.0,510.0,3084.75,Saturday,2023-07-22 19:38:13
F4DX44PQXE,"Robertson, Schneider and Jimenez",Till No,0.0,2355.0,3594.75,Saturday,2023-07-22 18:56:14
T275DMSMCN,Shwari Withdraw,Mshwari Withdraw,5000.0,0.0,5949.75,Saturday,2023-07-22 18:52:46
LE8GCLHKYO,Other,Other,0.0,1000.0,949.75,Friday,2023-07-21 20:01:12
288D0B0Q2G,Shwari Withdraw,Mshwari Withdraw,1000.0,0.0,1949.75,Friday,2023-07-21 20:00:30
F1XAROZXCE,Stout LLC,Till No,0.0,100.0,949.75,Wednesday,2023-07-19 11:21:33
7S0CPFOPHZ,Shwari Withdraw,Mshwari Withdraw,1000.0,0.0,1049.75,Wednesday,2023-07-19 11:21:05
SJWA8MK784,Other,Other,0.0,1000.0,49.75,Tuesday,2023-07-18 08:13:32
T0M1925H8A,Airtime Purchase,Airtime Purchase,0.0,50.0,1049.75,Monday,2023-07-17 15:18:23
XGPRZ548QG,Hernandez Ltd,Till No,0.0,200.0,1099.75,Monday,2023-07-17 10:42:57
F2XBDADUND,Amy Williams,Send Money,0.0,100.0,1299.75,Sunday,2023-07-16 12:57:44
YO857B8063,Jones Ltd,Till No,0.0,10.0,1399.75,Friday,2023-07-14 11:27:09
BRMCQFC071,Mpesa Charges,Mpesa Charges,0.0,1.7,1409.75,Friday,2023-07-14 10:21:52
Z54863AYKW,Paul PLC,Till No,0.0,340.0,1411.45,Friday,2023-07-14 10:21:52
GSUVE2E6L0,Shwari Deposit,Mshwari Deposit,0.0,80000.0,1751.45,Friday,2023-07-14 07:37:08
NCTGNFUN3M,Mpesa Charges,Mpesa Charges,0.0,105.0,81751.45,Friday,2023-07-14 07:36:13
FI9MK3940Y,Reed PLC,Pay Bill,0.0,150000.0,81856.45,Friday,2023-07-14 07:36:13
E56F75UIOF,Mpesa Charges,Mpesa Charges,0.0,6.0,231856.45,Thursday,2023-07-13 18:16:50
Q50MJHPHTC,Michael Sanchez,Send Money,0.0,160.0,231862.45,Thursday,2023-07-13 18:16:50
5YWN7VOX7X,Patrick Ltd,Till No,0.0,400.0,232022.45,Thursday,2023-07-13 18:08:28
VWKN73AEZC,Young and Sons,Bank Transfer,30000.0,0.0,232422.45,Thursday,2023-07-13 15:40:05
VXCOUFX7DZ,Young and Sons,Bank Transfer,100000.0,0.0,202422.45,Thursday,2023-07-13 15:39:04
YCMU708O9P,"Mitchell, Anderson and Bryant",Bank Transfer,100000.0,0.0,102422.45,Thursday,2023-07-13 15:38:05
N6X7V5ZW6Z,Michael Sanchez,Send Money,0.0,70.0,2422.45,Wednesday,2023-07-12 19:37:47
Z2UMOBREUV,Mpesa Charges,Mpesa Charges,0.0,6.0,2492.45,Wednesday,2023-07-12 19:33:39
A5Q7LQKFNB,Benjamin Villanueva,Send Money,0.0,270.0,2498.45,Wednesday,2023-07-12 19:33:39
E1T0LTC4FR,Mpesa Charges,Mpesa Charges,0.0,4.0,2768.45,Monday,2023-07-10 19:22:56
W8NWTDBKMR,White-Fowler,Pay Bill,0.0,500.0,2772.45,Monday,2023-07-10 19:22:56
AOBICYJHVD,Mpesa Charges,Mpesa Charges,0.0,4.0,3272.45,Monday,2023-07-10 19:19:31
C1MUQ9V4B0,White-Fowler,Pay Bill,0.0,500.0,3276.45,Monday,2023-07-10 19:19:31
YJETVW3XF2,Shwari Withdraw,Mshwari Withdraw,2012.0,0.0,3776.45,Monday,2023-07-10 19:17:17
8LMA6DQQN1,Michael Sanchez,Send Money,0.0,90.0,1764.45,Monday,2023-07-10 19:15:00
P39Q5TYF11,Mpesa Charges,Mpesa Charges,0.0,6.0,1854.45,Monday,2023-07-10 19:13:43
ID9B41SIIK,Benjamin Villanueva,Send Money,0.0,500.0,1860.45,Monday,2023-07-10 19:13:43
OJYA0BX2OI,Mpesa Charges,Mpesa Charges,0.0,32.0,2360.45,Monday,2023-07-10 19:01:46
539IHGPJI6,Valerie Ayala MD,Send Money,0.0,1980.0,2392.45,Monday,2023-07-10 19:01:46
5PURCO358C,Mpesa Charges,Mpesa Charges,0.0,6.0,4372.45,Sunday,2023-07-09 19:18:11
TAPKTK450V,Benjamin Villanueva,Send Money,0.0,340.0,4378.45,Sunday,2023-07-09 19:18:11
VPOG3Z0YFK,Baker-Franco,Till No,0.0,110.0,4718.45,Sunday,2023-07-09 19:10:44
LOSFDLZ8B9,Lindsey Johnson,Send Money,0.0,40.0,4828.45,Sunday,2023-07-09 19:08:16
C5KTWSWFIJ,Elizabeth Kim,Send Money,0.0,30.0,4868.45,Sunday,2023-07-09 19:04:10
U5012UJCPY,Lewis-Smith,Till No,0.0,65.0,4898.45,Sunday,2023-07-09 11:27:24
3J41AWS1DB,Mpesa Charges,Mpesa Charges,0.0,6.0,4963.45,Saturday,2023-07-08 15:57:46
TH0IZUZKJL,Nichole Brown,Send Money,0.0,200.0,4969.45,Saturday,2023-07-08 15:57:46
2Y5UKEZEPE,Evans-Green,Till No,0.0,900.0,5169.45,Saturday,2023-07-08 15:39:38
WRP71WUL14,Nicolas Orr,Send Money,0.0,60.0,6069.45,Saturday,2023-07-08 14:18:25
T0E2Y25BNH,"Yates, Bryan and Pope",Till No,0.0,40.0,6129.45,Saturday,2023-07-08 12:58:46
2SRTMVJUSE,Mpesa Charges,Mpesa Charges,0.0,9.0,6169.45,Saturday,2023-07-08 10:13:23
LDZQ3Q4S9Q,Hester-Lopez,Pay Bill,0.0,1000.0,6178.45,Saturday,2023-07-08 10:13:23
0EJRZ5R4HQ,Mpesa Charges,Mpesa Charges,0.0,4.0,7178.45,Saturday,2023-07-08 10:06:56
07HOO5NS6X,Mayo-Yates,Pay Bill,0.0,200.0,7182.45,Saturday,2023-07-08 10:06:56
7AI3IBLH80,Mpesa Charges,Mpesa Charges,0.0,6.0,7382.45,Saturday,2023-07-08 10:05:16
G7OJXR8JQE,Katherine Reyes,Send Money,0.0,450.0,7388.45,Saturday,2023-07-08 10:05:16
8D5CI11LHS,Mpesa Charges,Mpesa Charges,0.0,24.0,7838.45,Friday,2023-07-07 23:12:59
5WIZ8R12HV,Williams and Sons,Pay Bill,0.0,3272.0,7862.45,Friday,2023-07-07 23:12:59
BU32ZYVIR2,Mpesa Charges,Mpesa Charges,0.0,6.0,11134.45,Friday,2023-07-07 19:25:10
LB4DSQJ2QX,Michael Sanchez,Send Money,0.0,160.0,11140.45,Friday,2023-07-07 19:25:10
8A9R8ZBR7B,Mpesa Charges,Mpesa Charges,0.0,9.0,11300.45,Friday,2023-07-07 18:43:17
3GQMAGMG5L,Davidson-Figueroa,Pay Bill,0.0,760.0,11309.45,Friday,2023-07-07 18:43:17
3COLPSI72Z,Mpesa Charges,Mpesa Charges,0.0,6.0,12069.45,Thursday,2023-07-06 19:30:52
EA7DGKNV1Z,"Hill, Matthews and Martin",Till No,0.0,300.0,12245.45,Thursday,2023-07-06 15:19:24
BTBKFA9MOS,Mpesa Charges,Mpesa Charges,0.0,6.0,12545.45,Tuesday,2023-07-04 20:17:01
F714TJJWVX,Benjamin Villanueva,Send Money,0.0,210.0,12551.45,Tuesday,2023-07-04 20:17:01
G5QUTHK48W,Mpesa Charges,Mpesa Charges,0.0,80.0,12761.45,Tuesday,2023-07-04 12:07:24
938CWPI2NB,"Caldwell, King and Taylor",Pay Bill,0.0,31100.0,12841.45,Tuesday,2023-07-04 12:07:24
ITNOUCPALD,Shwari Withdraw,Mshwari Withdraw,40000.0,0.0,43941.45,Tuesday,2023-07-04 12:03:37
QRVU447B5W,Mpesa Charges,Mpesa Charges,0.0,105.0,3941.45,Tuesday,2023-07-04 12:00:20
94N00I3VZ0,Reed PLC,Pay Bill,0.0,100000.0,4046.45,Tuesday,2023-07-04 12:00:20
K7SMBRKQJJ,Shwari Withdraw,Mshwari Withdraw,100000.0,0.0,104046.45,Tuesday,2023-07-04 11:59:24
DSBW7XP8DO,Mpesa Charges,Mpesa Charges,0.0,105.0,4046.45,Tuesday,2023-07-04 11:43:43
OQJNYBBXAP,Michael Suarez,Send Money,0.0,30000.0,4151.45,Tuesday,2023-07-04 11:43:43
ADAYJ63A8X,Derrick Fischer,Send Money,0.0,30000.0,4151.45,Tuesday,2023-07-04 11:43:43
31AM48LXOX,Shwari Withdraw,Mshwari Withdraw,30000.0,0.0,34151.45,Tuesday,2023-07-04 11:43:09
TJOKE3E7B1,Shwari Lock Activate and Save from Savings,Other,0.0,0.0,4151.45,Tuesday,2023-07-04 11:42:00
864RRPT7YC,Mpesa Charges,Mpesa Charges,0.0,6.0,4151.45,Tuesday,2023-07-04 07:31:58
QXSL3EUT9D,Robyn Lopez,Send Money,0.0,500.0,4157.45,Tuesday,2023-07-04 07:31:58
D8AJSJRIDM,Michael Sanchez,Send Money,0.0,95.0,4657.45,Monday,2023-07-03 20:35:44
2KDP6X66UF,Benjamin Villanueva,Send Money,0.0,60.0,4752.45,Monday,2023-07-03 20:33:49
L111AI5EA2,Mpesa Charges,Mpesa Charges,0.0,4.0,4812.45,Monday,2023-07-03 14:45:49
XO4FSDNZBB,White-Fowler,Pay Bill,0.0,500.0,4816.45,Monday,2023-07-03 14:45:49
ZA1NUMI3XT,Walker Inc,Till No,0.0,90.0,5316.45,Monday,2023-07-03 14:33:55
1KH53Z7VNT,Tiffany Walker,Send Money,0.0,50.0,5406.45,Monday,2023-07-03 11:46:17
TI0IYQ9J0C,Airtime Purchase,Airtime Purchase,0.0,500.0,5456.45,Monday,2023-07-03 09:14:35
K1XWFLKGVA,Mpesa Charges,Mpesa Charges,0.0,12.0,5956.45,Monday,2023-07-03 08:36:19
Y0GDW7U7WH,Kimberly Jenkins,Send Money,0.0,520.0,5968.45,Monday,2023-07-03 08:36:19
3MWR8I50AR,"Carlson, Smith and Thomas",Till No,0.0,285.0,6488.45,Monday,2023-07-03 07:57:20
BY1BYQ207N,Mpesa Charges,Mpesa Charges,0.0,6.0,6773.45,Monday,2023-07-03 07:30:40
CGNS2U85L0,Mark Patterson,Send Money,0.0,160.0,6779.45,Monday,2023-07-03 07:30:40
SIPY10RKW1,Mpesa Charges,Mpesa Charges,0.0,12.0,6939.45,Saturday,2023-07-01 21:52:58
O6BEWK3TG9,Brittany Rodriguez,Send Money,0.0,890.0,6951.45,Saturday,2023-07-01 21:52:58
6BFYPSA8F9,"Keith, Phillips and Singleton",Pay Bill,0.0,4100.0,7841.45,Saturday,2023-07-01 12:00:05
P6BV6WM2OS,Shwari Withdraw,Mshwari Withdraw,10000.0,0.0,11941.45,Saturday,2023-07-01 11:59:21
RQEXBV5JHM,Stephanie Briggs,Send Money,0.0,100.0,1941.45,Saturday,2023-07-01 11:47:30
IU53L61FHW,Michael Sanchez,Send Money,0.0,50.0,2041.45,Saturday,2023-07-01 11:29:39
70XCVF2OR9,"Barajas, Cox and Reid",Pay Bill,0.0,100.0,2091.45,Saturday,2023-07-01 08:09:07
1VAAFR1X8M,"Aguirre, Gray and Gonzalez",Till No,0.0,300.0,2191.45,Friday,2023-06-30 19:05:46
EV71H5XV2N,Mpesa Charges,Mpesa Charges,0.0,24.0,2491.45,Friday,2023-06-30 18:53:35
CPNRUGBKFJ,Yates-Dunn,Pay Bill,0.0,2900.0,2515.45,Friday,2023-06-30 18:53:35
E7A06CRMRT,Shwari Withdraw,Mshwari Withdraw,5000.0,0.0,5415.45,Friday,2023-06-30 18:52:22
G0SP7163H2,Airtime Purchase,Airtime Purchase,0.0,50.0,415.45,Friday,2023-06-30 15:21:55
1YWOVMWKED,Mpesa Charges,Mpesa Charges,0.0,19.0,465.45,Friday,2023-06-30 10:03:54
H4ULLCAODX,"Pearson, Edwards and Mcdowell",Pay Bill,0.0,2030.0,484.45,Friday,2023-06-30 10:03:54
002BAJJ1D2,Mpesa Charges,Mpesa Charges,0.0,24.0,2514.45,Friday,2023-06-30 10:01:52
WFEHY3ZZUR,"Pearson, Edwards and Mcdowell",Pay Bill,0.0,2900.0,2538.45,Friday,2023-06-30 10:01:52
C5ABE0UP7C,Shwari Withdraw,Mshwari Withdraw,5000.0,0.0,5438.45,Friday,2023-06-30 09:55:01
CPQ27BNI0C,Mpesa Charges,Mpesa Charges,0.0,32.0,438.45,Thursday,2023-06-29 17:38:02
ZG9EPJT4GK,Kimberly White,Send Money,0.0,1630.0,470.45,Thursday,2023-06-29 17:38:02
UPLABUHZHZ,"Stanley, Potter and Morales",Till No,0.0,260.0,2100.45,Thursday,2023-06-29 16:21:15
1ZPI3EZDGL,"Jones, Martinez and Mendez",Bank Transfer,500.0,0.0,2360.45,Thursday,2023-06-29 14:17:13
WU90NKBUMG,"Welch, Singleton and Callahan",Till No,0.0,370.0,1860.45,Thursday,2023-06-29 13:55:20
VXNTHESFOT,Mpesa Charges,Mpesa Charges,0.0,32.0,2230.45,Thursday,2023-06-29 12:50:19
IS0BVZC7ZK,Cheryl Reilly,Send Money,0.0,1530.0,2262.45,Thursday,2023-06-29 12:50:19
6F66SMFERY,Jacob Riddle,Send Money,0.0,100.0,3792.45,Wednesday,2023-06-28 16:19:14
XVNV40RLNT,Evans-Green,Till No,0.0,650.0,3892.45,Wednesday,2023-06-28 15:55:21
1YY8L1679S,Mpesa Charges,Mpesa Charges,0.0,14.0,4542.45,Wednesday,2023-06-28 11:56:28
T9MLPC1ZV5,Reid LLC,Pay Bill,0.0,1500.0,4556.45,Wednesday,2023-06-28 11:56:28
UZJDK4VU7U,Mpesa Charges,Mpesa Charges,0.0,4.0,6056.45,Wednesday,2023-06-28 10:46:30
BHG3C022MM,Mayo-Yates,Pay Bill,0.0,300.0,6060.45,Wednesday,2023-06-28 10:46:30
56KDCIIWIZ,Shwari Withdraw,Mshwari Withdraw,5000.0,0.0,6360.45,Wednesday,2023-06-28 10:38:05
NGA7LL5ZTR,Mpesa Charges,Mpesa Charges,0.0,6.0,1360.45,Wednesday,2023-06-28 10:34:39
0WAM1WGZTY,Shari Mcpherson,Send Money,0.0,270.0,1366.45,Wednesday,2023-06-28 10:34:39
KYDT997JEV,Mpesa Charges,Mpesa Charges,0.0,4.0,1636.45,Tuesday,2023-06-27 20:52:25
RZUS9GJ6M2,Ward-Peterson,Pay Bill,0.0,250.0,1640.45,Tuesday,2023-06-27 20:52:25
Y0K1XL2IL0,Mpesa Charges,Mpesa Charges,0.0,22.0,1890.45,Tuesday,2023-06-27 19:49:38
A5TRAWCF8L,Jeremy Munoz,Send Money,0.0,1250.0,1912.45,Tuesday,2023-06-27 19:49:38
0YNQOQPAQD,Shwari Withdraw,Mshwari Withdraw,2000.0,0.0,3162.45,Tuesday,2023-06-27 19:48:30
FK3DI0GG6P,Mpesa Charges,Mpesa Charges,0.0,4.0,1162.45,Tuesday,2023-06-27 19:25:02
4PWUXMWXUT,White-Fowler,Pay Bill,0.0,500.0,1166.45,Tuesday,2023-06-27 19:25:02
FYV9TDD7E2,"Johnson, Craig and Garcia",Till No,0.0,65.0,1666.45,Tuesday,2023-06-27 18:57:10
VRMTR4Y9O0,Michael Sanchez,Send Money,0.0,60.0,1731.45,Tuesday,2023-06-27 18:55:54
SVRQ02KIIB,Mpesa Charges,Mpesa Charges,0.0,105.0,1791.45,Tuesday,2023-06-27 18:21:43
LZU3X9JZS3,Gordon and Sons,Pay Bill,0.0,85500.0,1896.45,Tuesday,2023-06-27 18:21:43
VUCWGK5J2J,Mpesa Charges,Mpesa Charges,0.0,28.0,87396.45,Tuesday,2023-06-27 16:56:23
39LH0UK1WH,"Copeland, Potter and Snyder",Cash Withdrawal,0.0,1000.0,87424.45,Tuesday,2023-06-27 16:56:23
1AJTKEP3EV,Shwari Deposit,Mshwari Deposit,0.0,50000.0,88424.45,Tuesday,2023-06-27 16:10:57
NJRDJG0WL7,Shwari Deposit,Mshwari Deposit,0.0,150000.0,138424.45,Tuesday,2023-06-27 16:10:36
MOXLIH2PN8,Amanda Norton,Send Money,0.0,100.0,288424.45,Tuesday,2023-06-27 16:06:36
C6OY11ARQE,Mpesa Charges,Mpesa Charges,0.0,32.0,288524.45,Monday,2023-06-26 15:04:19
EV0N9ZTKX9,Joseph Perez,Send Money,0.0,2300.0,288556.45,Monday,2023-06-26 15:04:19
2WFOOKH3D5,Dorothy Price,Send Money,0.0,2300.0,288556.45,Monday,2023-06-26 15:04:19
T5UY1SPX7E,"Hill, Matthews and Martin",Till No,0.0,300.0,290856.45,Monday,2023-06-26 10:15:35
IBDU19MFDN,Mpesa Charges,Mpesa Charges,0.0,12.0,291156.45,Sunday,2023-06-25 19:51:12
6DK3RGV9NP,William Smith,Send Money,0.0,570.0,291168.45,Sunday,2023-06-25 19:51:12
F5IPZTACNC,"Carlson, Smith and Thomas",Till No,0.0,1308.0,291738.45,Sunday,2023-06-25 19:13:08
V6OEPEU8XM,Logan Group,Bank Transfer,85000.0,0.0,293046.45,Sunday,2023-06-25 17:16:35
MBWFQ68QHS,Herrera and Sons,Bank Transfer,100000.0,0.0,208046.45,Sunday,2023-06-25 17:15:14
3J64U6TMH3,Peterson Ltd,Bank Transfer,100000.0,0.0,108046.45,Sunday,2023-06-25 17:14:07
0ASVO1SDCD,Mpesa Charges,Mpesa Charges,0.0,9.0,8046.45,Sunday,2023-06-25 11:07:57
V04QYA3XVC,"Garcia, White and Bradley",Pay Bill,0.0,928.0,8055.45,Sunday,2023-06-25 11:07:57
N5MPA61ESB,"Contreras, Torres and Nguyen",Till No,0.0,1660.0,8983.45,Sunday,2023-06-25 09:12:12
AYTPWOQ1ZU,Shwari Withdraw,Mshwari Withdraw,10000.0,0.0,10643.45,Sunday,2023-06-25 08:54:38
LZGMBB2Z6N,Nathan Stephens,Send Money,0.0,60.0,643.45,Sunday,2023-06-25 07:52:32
YBNI4IY831,Mpesa Charges,Mpesa Charges,0.0,6.0,703.45,Saturday,2023-06-24 20:44:49
H90ARCJ10C,Michael Sanchez,Send Money,0.0,200.0,709.45,Saturday,2023-06-24 20:44:49
DKTA8CYW10,Mpesa Charges,Mpesa Charges,0.0,75.0,909.45,Saturday,2023-06-24 15:57:30
PYM07SASKM,Michael Suarez,Send Money,0.0,5250.0,984.45,Saturday,2023-06-24 15:57:30
KDY4NK3G19,Derrick Fischer,Send Money,0.0,5250.0,984.45,Saturday,2023-06-24 15:57:30
MAU2U0WD44,Shwari Withdraw,Mshwari Withdraw,5250.0,0.0,6234.45,Saturday,2023-06-24 15:56:46
L1Q8Q76UPK,Other,Other,0.0,1000.0,984.45,Saturday,2023-06-24 14:40:29
EIX5P4FV49,Mpesa Charges,Mpesa Charges,0.0,55.0,1984.45,Saturday,2023-06-24 14:02:14
LYU70W1YQJ,Joseph Perez,Send Money,0.0,5000.0,2039.45,Saturday,2023-06-24 14:02:14
TMBEFO0NEV,Dorothy Price,Send Money,0.0,5000.0,2039.45,Saturday,2023-06-24 14:02:14
NVR06CCLD0,Susan Scott,Send Money,0.0,100.0,7039.45,Friday,2023-06-23 22:18:16
J6KJWBWY9F,"Gomez, Rice and Simpson",Till No,0.0,2034.0,7139.45,Friday,2023-06-23 22:13:34
25DOKV1L0E,"Taylor, Williams and Lara",Till No,0.0,480.0,9173.45,Friday,2023-06-23 22:08:52
DPLU8U4CY4,Jones LLC,Till No,0.0,400.0,9653.45,Friday,2023-06-23 20:50:30
OQBQ32U0JA,Nichols LLC,Till No,0.0,2500.0,10053.45,Friday,2023-06-23 18:32:19
JIQPVPIU9Y,Mpesa Charges,Mpesa Charges,0.0,6.0,12553.45,Friday,2023-06-23 18:25:45
ZQ55PQTOIY,Chad Taylor,Send Money,0.0,260.0,12559.45,Friday,2023-06-23 18:25:45
SLY1CD08QU,Mpesa Charges,Mpesa Charges,0.0,12.0,12819.45,Friday,2023-06-23 17:23:19
7E9IM637GD,Sophia Butler,Send Money,0.0,960.0,12831.45,Friday,2023-06-23 17:23:19
CWK481TUC0,Shwari Withdraw,Mshwari Withdraw,3262.0,0.0,13791.45,Friday,2023-06-23 17:15:00
TZ1S5I2NLL,Newton-Brown,Bank Transfer,10000.0,0.0,10529.45,Friday,2023-06-23 17:13:26
WKP48M4K5W,Airtime Purchase,Airtime Purchase,0.0,50.0,529.45,Friday,2023-06-23 16:30:24
OY12RE4L9U,Mpesa Charges,Mpesa Charges,0.0,12.0,579.45,Friday,2023-06-23 15:09:59
5AXUZGIXJ9,Valerie Jones,Send Money,0.0,830.0,591.45,Friday,2023-06-23 15:09:59
L07KB3KPV3,Mpesa Charges,Mpesa Charges,0.0,4.0,1421.45,Friday,2023-06-23 14:07:00
E8BL4UYTW5,White-Fowler,Pay Bill,0.0,500.0,1425.45,Friday,2023-06-23 14:07:00
95U2245Z7L,Mpesa Charges,Mpesa Charges,0.0,87.0,1925.45,Friday,2023-06-23 09:14:50
OS3H51HTGI,Michael Suarez,Send Money,0.0,10000.0,2012.45,Friday,2023-06-23 09:14:50
8EL7J406V9,Derrick Fischer,Send Money,0.0,10000.0,2012.45,Friday,2023-06-23 09:14:50
GRNS5QKBLC,Shwari Withdraw,Mshwari Withdraw,10000.0,0.0,12012.45,Friday,2023-06-23 09:14:16
65VGQTSLS3,Mpesa Charges,Mpesa Charges,0.0,32.0,2012.45,Thursday,2023-06-22 19:57:58
2YVSQMVSTB,Brian Nguyen,Send Money,0.0,1520.0,2044.45,Thursday,2023-06-22 19:57:58
5LOHB2XEXO,Mpesa Charges,Mpesa Charges,0.0,51.0,3564.45,Thursday,2023-06-22 15:02:46
KRW4ERUX7W,Chad Hopkins,Send Money,0.0,2805.0,3615.45,Thursday,2023-06-22 15:02:46
2VAGG4D0G6,Mpesa Charges,Mpesa Charges,0.0,6.0,6420.45,Thursday,2023-06-22 14:37:11
BZG7HC5PF7,William Pena,Send Money,0.0,400.0,6426.45,Thursday,2023-06-22 14:37:11
YLVP4EYMYZ,Jesse Gardner,Send Money,0.0,100.0,6826.45,Wednesday,2023-06-21 19:46:16
NVXU1SP9CB,"Krueger, Woods and Campbell",Pay Bill,0.0,60.0,6926.45,Wednesday,2023-06-21 19:39:07
NLCHHNFLXE,Mpesa Charges,Mpesa Charges,0.0,32.0,6986.45,Wednesday,2023-06-21 18:31:41
P5F9W0UH8A,Jesse Gardner,Send Money,0.0,1600.0,7018.45,Wednesday,2023-06-21 18:31:41
1KD4I8L5XC,Stacey Fletcher,Receive Money,3000.0,0.0,8618.45,Wednesday,2023-06-21 18:17:10
VHETJ2UVM4,Mpesa Charges,Mpesa Charges,0.0,4.0,5618.45,Wednesday,2023-06-21 17:46:41
4HJEM77VG8,Rowland Ltd,Pay Bill,0.0,300.0,5622.45,Wednesday,2023-06-21 17:46:41
3WIAUTKZR5,Mpesa Charges,Mpesa Charges,0.0,22.0,5922.45,Wednesday,2023-06-21 16:00:38
QE67ND8GYH,Sarah Barrett,Send Money,0.0,1410.0,5944.45,Wednesday,2023-06-21 16:00:38
NA5JERLXI8,Annette Hines,Send Money,0.0,50.0,7354.45,Wednesday,2023-06-21 12:14:31
11O94HS7JP,"Gomez, Rice and Simpson",Till No,0.0,1093.0,7404.45,Wednesday,2023-06-21 12:07:15
FE4D7BGYK1,Mpesa Charges,Mpesa Charges,0.0,6.0,8497.45,Wednesday,2023-06-21 11:58:58
VDRP9I2SGB,Gary Mclaughlin,Send Money,0.0,220.0,8503.45,Wednesday,2023-06-21 11:58:58
J2SPE534O8,"Barajas, Cox and Reid",Pay Bill,0.0,100.0,8723.45,Wednesday,2023-06-21 09:25:14
L7KZDFL4YN,Mpesa Charges,Mpesa Charges,0.0,6.0,8823.45,Tuesday,2023-06-20 21:13:56
ST4W8P2W55,Benjamin Villanueva,Send Money,0.0,120.0,8829.45,Tuesday,2023-06-20 21:13:56
TIYWYHJCVU,Mpesa Charges,Mpesa Charges,0.0,32.0,8949.45,Tuesday,2023-06-20 21:10:30
X0QF9ZNFOT,Rebecca Jones,Send Money,0.0,1600.0,8981.45,Tuesday,2023-06-20 21:10:30
IU6TWEPIPG,Moore and Sons,Bank Transfer,10000.0,0.0,10581.45,Tuesday,2023-06-20 20:51:25
BUD458J61L,Mpesa Charges,Mpesa Charges,0.0,6.0,581.45,Tuesday,2023-06-20 09:26:42
J3DAN5Y0R2,Sarah Lee,Send Money,0.0,500.0,587.45,Tuesday,2023-06-20 09:26:42
W9KUJB0698,Mpesa Charges,Mpesa Charges,0.0,14.0,1087.45,Monday,2023-06-19 20:08:47
O6GN341CDJ,"Benitez, Palmer and Lane",Pay Bill,0.0,1358.0,1101.45,Monday,2023-06-19 20:08:47
IZC4T9VIBR,Mpesa Charges,Mpesa Charges,0.0,22.0,2459.45,Monday,2023-06-19 08:08:57
5OQNWLZNUK,Brittany Schaefer,Send Money,0.0,1190.0,2481.45,Monday,2023-06-19 08:08:57
GAC5LNSDNZ,Buck Group,Till No,0.0,1790.0,3671.45,Sunday,2023-06-18 19:54:44
AIAF2LYGWZ,Mpesa Charges,Mpesa Charges,0.0,12.0,5461.45,Saturday,2023-06-17 21:13:52
U2J0TS82AZ,Kathryn Jones,Send Money,0.0,780.0,5473.45,Saturday,2023-06-17 21:13:52
8K227OJEC9,Baker-Franco,Till No,0.0,420.0,6253.45,Saturday,2023-06-17 20:37:59
M2JN4OMFNV,Benjamin Villanueva,Send Money,0.0,100.0,6673.45,Saturday,2023-06-17 20:36:15
RX3C2JLG2E,Michael Sanchez,Send Money,0.0,50.0,6773.45,Saturday,2023-06-17 20:35:16
TLNZLUKWZZ,Mpesa Charges,Mpesa Charges,0.0,105.0,6823.45,Saturday,2023-06-17 16:19:26
QU9W2J6RMQ,"Caldwell, King and Taylor",Pay Bill,0.0,104000.0,6928.45,Saturday,2023-06-17 16:19:26
NUOWQTYZG3,Shwari Withdraw,Mshwari Withdraw,105000.0,0.0,110928.45,Saturday,2023-06-17 16:17:42
HK6YPR70KO,Mpesa Charges,Mpesa Charges,0.0,6.0,5928.45,Saturday,2023-06-17 15:46:30
IN3I19ARXV,Jordan Martin,Send Money,0.0,150.0,5934.45,Saturday,2023-06-17 15:46:30
OX08UE0EOH,Stephanie Briggs,Send Money,0.0,100.0,6084.45,Saturday,2023-06-17 11:41:58
4WCE4PLF2N,Mpesa Charges,Mpesa Charges,0.0,105.0,6184.45,Friday,2023-06-16 20:18:49
BWF7LUYXG5,Michael Suarez,Send Money,0.0,22800.0,6289.45,Friday,2023-06-16 20:18:49
WFY5P4M2K9,Derrick Fischer,Send Money,0.0,22800.0,6289.45,Friday,2023-06-16 20:18:49
BGBPA4VJYI,Shwari Withdraw,Mshwari Withdraw,22900.0,0.0,29089.45,Friday,2023-06-16 20:17:02
9Y351NINEP,Mpesa Charges,Mpesa Charges,0.0,4.0,6189.45,Friday,2023-06-16 18:19:38
3UFRBX94U2,Yates-Dunn,Pay Bill,0.0,120.0,6193.45,Friday,2023-06-16 18:19:38
0C629HJQY4,"Gomez, Rice and Simpson",Till No,0.0,954.0,6313.45,Friday,2023-06-16 18:08:57
5KKYCUU6AI,Elizabeth Morris,Send Money,0.0,100.0,7267.45,Friday,2023-06-16 18:00:54
4JMY5GWPLK,Frank Harris,Pochi,0.0,100.0,7367.45,Friday,2023-06-16 17:58:56
ZZDG2X9WVC,Mpesa Charges,Mpesa Charges,0.0,4.0,7467.45,Friday,2023-06-16 17:52:03
MYGLLKH1OS,Yates-Dunn,Pay Bill,0.0,200.0,7471.45,Friday,2023-06-16 17:52:03
LDSUTM9FV0,Mpesa Charges,Mpesa Charges,0.0,24.0,7671.45,Friday,2023-06-16 17:48:48
B8Z27B40DQ,Yates-Dunn,Pay Bill,0.0,3000.0,7695.45,Friday,2023-06-16 17:48:48
QMNXXTVLFK,Kim-Smith,Till No,0.0,100.0,10695.45,Friday,2023-06-16 16:08:04
5UKOVDYK64,Woods-Barrera,Bank Transfer,10000.0,0.0,10795.45,Friday,2023-06-16 12:26:14
6RZG3VEI7P,"Barajas, Cox and Reid",Pay Bill,0.0,100.0,795.45,Friday,2023-06-16 10:04:06
N364KKZ6AN,Mpesa Charges,Mpesa Charges,0.0,6.0,895.45,Friday,2023-06-16 10:03:00
O1PIBU7AP8,Brian Carroll,Send Money,0.0,120.0,901.45,Friday,2023-06-16 10:03:00
F3C0M1TWIY,Shwari Withdraw,Mshwari Withdraw,1000.0,0.0,1021.45,Friday,2023-06-16 10:02:45
4FHGKN4BXV,Mpesa Charges,Mpesa Charges,0.0,6.0,21.45,Thursday,2023-06-15 18:39:02
S4SWIPSUX5,Daniel Ellis,Send Money,0.0,120.0,27.45,Thursday,2023-06-15 18:39:02
8D0RDT9TUZ,Mpesa Charges,Mpesa Charges,0.0,6.0,147.45,Thursday,2023-06-15 18:34:50
A3KTRP68L6,Zachary Mitchell,Send Money,0.0,200.0,153.45,Thursday,2023-06-15 18:34:50
8D64MJ2XF9,"Barajas, Cox and Reid",Pay Bill,0.0,100.0,353.45,Thursday,2023-06-15 17:19:10
RYWFEMBQK4,Mpesa Charges,Mpesa Charges,0.0,6.0,453.45,Thursday,2023-06-15 17:18:28
16FMU4HV92,Matthew Jones,Send Money,0.0,240.0,459.45,Thursday,2023-06-15 17:18:28
2D043JPZ2L,Osborne-Vasquez,Till No,0.0,550.0,699.45,Thursday,2023-06-15 14:31:16
WH2A93PNLA,Audrey Wagner,Send Money,0.0,100.0,1249.45,Thursday,2023-06-15 14:30:31
PYLUGA75C7,Audrey Wagner,Send Money,0.0,100.0,1349.45,Wednesday,2023-06-14 15:30:17
EW0LJUB9S1,Osborne-Vasquez,Till No,0.0,450.0,1449.45,Wednesday,2023-06-14 15:29:59
5C7WBMYN2W,Mpesa Charges,Mpesa Charges,0.0,22.0,1899.45,Wednesday,2023-06-14 14:41:35
2UMH60HQYZ,Nicole Kennedy,Send Money,0.0,1200.0,1921.45,Wednesday,2023-06-14 14:41:35
UMMMMU6W53,Shwari Withdraw,Mshwari Withdraw,2700.0,0.0,3121.45,Wednesday,2023-06-14 14:41:17
SU388MZA36,Mpesa Charges,Mpesa Charges,0.0,22.0,421.45,Wednesday,2023-06-14 09:37:32
YCB5HNG4TG,Sarah Lee,Send Money,0.0,1500.0,443.45,Wednesday,2023-06-14 09:37:32
601ESIZII8,Michael Sanchez,Send Money,0.0,40.0,1943.45,Tuesday,2023-06-13 19:56:51
FWTG5MVEOW,Mpesa Charges,Mpesa Charges,0.0,6.0,1983.45,Tuesday,2023-06-13 19:55:27
I9891HN00C,Steven Holloway,Pochi,0.0,240.0,1989.45,Tuesday,2023-06-13 19:55:27
1VIZICJQTQ,"Hill, Matthews and Martin",Till No,0.0,300.0,2229.45,Tuesday,2023-06-13 19:46:22
4XE0ZZDLHU,Mpesa Charges,Mpesa Charges,0.0,24.0,2529.45,Tuesday,2023-06-13 12:16:20
H6CH8ZAA5Q,Williams and Sons,Pay Bill,0.0,3145.0,2553.45,Tuesday,2023-06-13 12:16:20
NHDB856JVN,Mpesa Charges,Mpesa Charges,0.0,12.0,5698.45,Monday,2023-06-12 19:56:15
789L1YBAMZ,Antonio Shea,Send Money,0.0,780.0,5710.45,Monday,2023-06-12 19:56:15
WPVUR5IIQV,Buck Group,Till No,0.0,2000.0,6490.45,Monday,2023-06-12 19:28:20
EMB12O1QPW,Mpesa Charges,Mpesa Charges,0.0,22.0,8490.45,Monday,2023-06-12 18:55:03
AHMELE30ZM,Jennifer Jones,Send Money,0.0,1500.0,8512.45,Monday,2023-06-12 18:55:03
LURN4677KW,Gallegos Inc,Bank Transfer,10000.0,0.0,10012.45,Monday,2023-06-12 18:54:04
3EMLFY0YAP,Mpesa Charges,Mpesa Charges,0.0,27.0,12.45,Monday,2023-06-12 17:06:26
W2WE8135T4,Moore-Leonard,Cash Withdrawal,0.0,300.0,39.45,Monday,2023-06-12 17:06:26
ZE7YUG16GU,Mpesa Charges,Mpesa Charges,0.0,12.0,339.45,Monday,2023-06-12 16:18:43
6GHPLBM1C8,David Kim,Send Money,0.0,770.0,351.45,Monday,2023-06-12 16:18:43
QNPERYZDZW,Mpesa Charges,Mpesa Charges,0.0,32.0,1121.45,Sunday,2023-06-11 21:08:56
LBLD7XDKII,Veronica Richardson,Send Money,0.0,2268.0,1153.45,Sunday,2023-06-11 21:08:56
DL2FDTOMVY,Mpesa Charges,Mpesa Charges,0.0,4.0,3421.45,Sunday,2023-06-11 18:40:00
DCU9UGVDPN,White-Fowler,Pay Bill,0.0,500.0,3425.45,Sunday,2023-06-11 18:40:00
UQDX3GYSQO,Mpesa Charges,Mpesa Charges,0.0,12.0,3925.45,Sunday,2023-06-11 15:53:18
88R5NL2HZ4,Michael Boone,Send Money,0.0,670.0,3937.45,Sunday,2023-06-11 15:53:18
Y2JRP3AWK1,"Vega, Smith and Jackson",Till No,0.0,1600.0,4607.45,Sunday,2023-06-11 14:10:19
FHXR9KVDK6,Mpesa Charges,Mpesa Charges,0.0,105.0,6207.45,Sunday,2023-06-11 11:07:32
QUJMXVILFP,Reed PLC,Pay Bill,0.0,50000.0,6312.45,Sunday,2023-06-11 11:07:32
JSRCF6OX46,"Powell, Orr and Goodman",Bank Transfer,50110.0,0.0,56312.45,Sunday,2023-06-11 11:06:59
PA2TVDTZHQ,Mpesa Charges,Mpesa Charges,0.0,9.0,6202.45,Sunday,2023-06-11 08:31:17
5E5KIAVVCJ,Wallace-Schneider,Pay Bill,0.0,800.0,6211.45,Sunday,2023-06-11 08:31:17
C1PKXGVXQQ,Mpesa Charges,Mpesa Charges,0.0,55.0,7011.45,Friday,2023-06-09 15:57:58
UJ8J652Q0N,Latoya Rivera,Send Money,0.0,4067.0,7066.45,Friday,2023-06-09 15:57:58
JVURVABNJX,Mpesa Charges,Mpesa Charges,0.0,2.5,11133.45,Friday,2023-06-09 08:42:09
GIDOQVTOR0,Harper-Williamson,Till No,0.0,500.0,11135.95,Friday,2023-06-09 08:42:09
YWZ94GUS3C,Mpesa Charges,Mpesa Charges,0.0,12.0,11635.95,Friday,2023-06-09 07:29:35
OJEBXE3S65,Brandy Thompson,Send Money,0.0,750.0,11647.95,Friday,2023-06-09 07:29:35
AWV9NGMMJW,Mpesa Charges,Mpesa Charges,0.0,12.0,12397.95,Thursday,2023-06-08 23:26:35
RICKI0K45R,Brian Martinez,Send Money,0.0,910.0,12409.95,Thursday,2023-06-08 23:26:35
6IQHWPDDH6,Mpesa Charges,Mpesa Charges,0.0,12.0,13319.95,Thursday,2023-06-08 21:41:23
ATYWD5FW4H,Terry Mcfarland,Send Money,0.0,800.0,13331.95,Thursday,2023-06-08 21:41:23
4TSPXIPPEU,Lopez-Rodgers,Till No,0.0,1000.0,14131.95,Thursday,2023-06-08 21:01:12
JBSY5APLM7,Smith-Lane,Till No,0.0,1200.0,15131.95,Thursday,2023-06-08 19:50:52
HF2E8PWR4W,Patrick Ltd,Till No,0.0,900.0,16331.95,Thursday,2023-06-08 19:42:31
2C00V9FEEM,Mpesa Charges,Mpesa Charges,0.0,6.0,17231.95,Thursday,2023-06-08 13:54:41
F98KNA8SK1,Steven Holloway,Pochi,0.0,200.0,17237.95,Thursday,2023-06-08 13:54:41
FGOHNJ6970,Mpesa Charges,Mpesa Charges,0.0,4.0,17437.95,Thursday,2023-06-08 13:49:17
F4OEQTF4NN,White-Fowler,Pay Bill,0.0,500.0,17441.95,Thursday,2023-06-08 13:49:17
RNX4S4M241,Mpesa Charges,Mpesa Charges,0.0,6.0,17941.95,Wednesday,2023-06-07 22:35:09
SZ3WMF2NS6,Jamie Smith,Send Money,0.0,360.0,17947.95,Wednesday,2023-06-07 22:35:09
5U6IUG8RUL,Mpesa Charges,Mpesa Charges,0.0,6.0,18307.95,Wednesday,2023-06-07 22:12:17
0MB0BXQFVC,Judy Park,Send Money,0.0,500.0,18313.95,Wednesday,2023-06-07 22:12:17
G34GY5B154,Diaz-Nichols,Till No,0.0,12950.0,18813.95,Wednesday,2023-06-07 22:11:09
B38L03YWJT,Mpesa Charges,Mpesa Charges,0.0,6.0,31763.95,Wednesday,2023-06-07 19:16:35
0DCZ6S6VND,David Carpenter,Send Money,0.0,340.0,31769.95,Wednesday,2023-06-07 19:16:35
0HRRYZRHS8,Mpesa Charges,Mpesa Charges,0.0,32.0,32109.95,Wednesday,2023-06-07 18:26:20
F7J0XDV05B,Andrea Bryan,Send Money,0.0,1900.0,32141.95,Wednesday,2023-06-07 18:26:20
6OCZDHH5FT,Airtime Purchase,Airtime Purchase,0.0,500.0,34041.95,Tuesday,2023-06-06 20:23:28
FZEZS0J5J0,Michael Sanchez,Send Money,0.0,100.0,34541.95,Tuesday,2023-06-06 20:12:10
EZQTEXXUES,Jonathan Mendoza,Send Money,0.0,100.0,34641.95,Tuesday,2023-06-06 20:10:47
1YFFYCY4EO,Reeves-Copeland,Till No,0.0,5400.0,34741.95,Tuesday,2023-06-06 19:51:18
PUE2LY8PHW,"Moon, Smith and Stevens",Till No,0.0,3900.0,40141.95,Tuesday,2023-06-06 19:09:47
9GLSZ1CW8P,Jonathan Mendoza,Send Money,0.0,100.0,44041.95,Tuesday,2023-06-06 18:46:56
IGSJ920LPZ,Mpesa Charges,Mpesa Charges,0.0,105.0,44141.95,Tuesday,2023-06-06 12:32:48
RZ79AJ9NTZ,Reed PLC,Pay Bill,0.0,50000.0,44246.95,Tuesday,2023-06-06 12:32:48
5VBIBPGZCW,Wilcox-Hess,Bank Transfer,50000.0,0.0,94246.95,Tuesday,2023-06-06 12:30:37
DVYDARVWAH,Mpesa Charges,Mpesa Charges,0.0,105.0,44246.95,Tuesday,2023-06-06 12:26:12
RVZXNRBDET,Reed PLC,Pay Bill,0.0,100000.0,44351.95,Tuesday,2023-06-06 12:26:12
616CR2VKOW,"Maxwell, Simmons and Collins",Bank Transfer,100000.0,0.0,144351.95,Tuesday,2023-06-06 12:25:28
1FZ459XI3Z,Mpesa Charges,Mpesa Charges,0.0,105.0,44351.95,Tuesday,2023-06-06 11:27:12
U1IAMVN6ID,Reed PLC,Pay Bill,0.0,100000.0,44456.95,Tuesday,2023-06-06 11:27:12
PZW9BBI7QM,Moore Ltd,Bank Transfer,100000.0,0.0,144456.95,Tuesday,2023-06-06 11:26:17
T4MHK77MK5,Mpesa Charges,Mpesa Charges,0.0,32.0,44456.95,Monday,2023-06-05 17:27:26
DKSDWITU40,Clinton Miller,Send Money,0.0,2040.0,44488.95,Monday,2023-06-05 17:27:26
Q9M721TUEN,Mpesa Charges,Mpesa Charges,0.0,80.0,46528.95,Monday,2023-06-05 12:17:56
I173LPRVUD,"Caldwell, King and Taylor",Pay Bill,0.0,31100.0,46608.95,Monday,2023-06-05 12:17:56
7ULS4SWEP1,Mpesa Charges,Mpesa Charges,0.0,65.0,77708.95,Monday,2023-06-05 11:19:29
ZTR5L0G9VJ,Cooper Group,Pay Bill,0.0,23100.0,77773.95,Monday,2023-06-05 11:19:29
XLDI5JZHH7,Macias-Coffey,Bank Transfer,100000.0,0.0,100873.95,Monday,2023-06-05 11:17:26
YYZS98ENW1,Mpesa Charges,Mpesa Charges,0.0,22.0,873.95,Monday,2023-06-05 08:39:50
9BR6VQKOTL,Ann Travis,Send Money,0.0,1050.0,895.95,Monday,2023-06-05 08:39:50
MGU02V4WUZ,Anthony Rivers,Send Money,0.0,50.0,1945.95,Sunday,2023-06-04 19:06:19
F6VZ02VK4R,Tanner Moore,Send Money,0.0,100.0,1995.95,Sunday,2023-06-04 18:54:24
MIAN0OJNYW,Mpesa Charges,Mpesa Charges,0.0,22.0,2095.95,Saturday,2023-06-03 13:07:32
UDP9DYXCVL,Michelle Montgomery,Send Money,0.0,1300.0,2117.95,Saturday,2023-06-03 13:07:32
CHNKZP0X1M,Mpesa Charges,Mpesa Charges,0.0,12.0,3417.95,Saturday,2023-06-03 07:40:31
BU0RUJS7J3,Cynthia Rose,Send Money,0.0,890.0,3429.95,Saturday,2023-06-03 07:40:31
AOZODQQE5Z,Mpesa Charges,Mpesa Charges,0.0,12.0,4319.95,Friday,2023-06-02 21:25:04
CLDVGRC3C1,Anthony Lyons,Send Money,0.0,850.0,4331.95,Friday,2023-06-02 21:25:04
NBDWZUUOWW,Anthony Rivers,Send Money,0.0,20.0,5181.95,Friday,2023-06-02 21:22:57
69SCR7HTY9,Reeves-Copeland,Till No,0.0,2423.0,5201.95,Friday,2023-06-02 20:29:57
ZGVLA5QPIC,"Moon, Smith and Stevens",Till No,0.0,990.0,7624.95,Friday,2023-06-02 20:01:06
5TIADTGGHO,Alexander Jackson,Send Money,0.0,100.0,8614.95,Friday,2023-06-02 19:53:22
6IX03Y8UX4,Shwari Withdraw,Mshwari Withdraw,1500.0,0.0,8714.95,Friday,2023-06-02 15:42:06
XEIEMO7CEE,Mpesa Charges,Mpesa Charges,0.0,105.0,7214.95,Friday,2023-06-02 15:40:38
76V8AXNBXP,Reed PLC,Pay Bill,0.0,50000.0,7319.95,Friday,2023-06-02 15:40:38
W3JD74P846,Mpesa Charges,Mpesa Charges,0.0,105.0,57319.95,Friday,2023-06-02 15:18:39
E8FTPF1720,Reed PLC,Pay Bill,0.0,50000.0,57424.95,Friday,2023-06-02 15:18:39
C3LMF1NISF,Hall-Garcia,Bank Transfer,100000.0,0.0,107424.95,Friday,2023-06-02 15:16:15
GMJHJNQJBB,Mpesa Charges,Mpesa Charges,0.0,9.0,7424.95,Thursday,2023-06-01 20:53:00
RI6ZCI2B5H,"Gardner, Curtis and Williams",Pay Bill,0.0,1000.0,7433.95,Thursday,2023-06-01 20:53:00
FGSHRIJ6SJ,Mpesa Charges,Mpesa Charges,0.0,51.0,8433.95,Thursday,2023-06-01 18:54:09
9LPJG8FZLW,Kenneth Hogan,Send Money,0.0,3500.0,8484.95,Thursday,2023-06-01 18:54:09
EEJY2BWIZI,Mpesa Charges,Mpesa Charges,0.0,6.0,11984.95,Thursday,2023-06-01 18:52:53
EBB5S9R9FT,Megan Wells,Send Money,0.0,150.0,11990.95,Thursday,2023-06-01 18:52:53
WWA28XZA6Z,Mcgee-Palmer,Till No,0.0,140.0,12140.95,Thursday,2023-06-01 18:30:23
11PO9PTWKB,Shelby Rivera,Send Money,0.0,100.0,12280.95,Thursday,2023-06-01 16:42:52
YZJBDY7YE5,Mpesa Charges,Mpesa Charges,0.0,22.0,12380.95,Thursday,2023-06-01 13:36:45
ZEEE0UFSFB,Christy Woods,Send Money,0.0,1500.0,12402.95,Thursday,2023-06-01 13:36:45
FOV0925GI6,"Butler, Wilson and Mercer",Till No,0.0,470.0,13902.95,Thursday,2023-06-01 13:16:41
WRUZHYMCAD,Other,Other,0.0,1000.0,14372.95,Thursday,2023-06-01 12:28:20
DBYIJKB8LW,"Jones, Williams and Schmidt",Till No,0.0,580.0,15372.95,Thursday,2023-06-01 11:34:21
AF16GHY91N,Mpesa Charges,Mpesa Charges,0.0,75.0,15952.95,Thursday,2023-06-01 11:15:45
8OJSITWG5O,Kenneth Hogan,Send Money,0.0,7000.0,16027.95,Thursday,2023-06-01 11:15:45
2W3OBPWMZE,Brock-York,Bank Transfer,20000.0,0.0,23027.95,Thursday,2023-06-01 11:15:17
7J5C9FG2JW,Kim-Everett,Till No,0.0,65.0,3027.95,Thursday,2023-06-01 09:01:08
VYI34PU4EJ,"Keith, Phillips and Singleton",Pay Bill,0.0,4100.0,3092.95,Thursday,2023-06-01 07:59:47
6R74Q07AIJ,Mpesa Charges,Mpesa Charges,0.0,32.0,7192.95,Wednesday,2023-05-31 17:35:58
IEUK0KVRCL,Kaitlyn Walker,Send Money,0.0,1650.0,7224.95,Wednesday,2023-05-31 17:35:58
JEA5JJ8JYS,"Nelson, Stewart and Graham",Till No,0.0,150.0,8874.95,Wednesday,2023-05-31 16:33:48
UT21U74E54,Carroll PLC,Till No,0.0,360.0,9024.95,Wednesday,2023-05-31 15:33:48
C4B1J4S0MG,"Stanley, Potter and Morales",Till No,0.0,190.0,9384.95,Wednesday,2023-05-31 15:22:09
T59QCD148I,Shwari Withdraw,Mshwari Withdraw,1372.0,0.0,9574.95,Wednesday,2023-05-31 15:20:50
MFF9NEUJVP,"Mueller, Burnett and Gill",Till No,0.0,400.0,8202.95,Wednesday,2023-05-31 15:12:59
0P72HDHQJB,"Butler, Goodwin and Brewer",Till No,0.0,60.0,8602.95,Wednesday,2023-05-31 14:36:03
F7W2CQQ6H7,Krueger-Best,Till No,0.0,25.0,8662.95,Wednesday,2023-05-31 14:32:34
PFMHJLNF72,Mpesa Charges,Mpesa Charges,0.0,22.0,8687.95,Wednesday,2023-05-31 14:26:17
02W2YCC5XF,Bryan Patterson,Send Money,0.0,1350.0,8709.95,Wednesday,2023-05-31 14:26:17
V8X22T7A4X,Mpesa Charges,Mpesa Charges,0.0,4.0,10059.95,Tuesday,2023-05-30 19:50:15
F74IIRIHW0,White-Fowler,Pay Bill,0.0,500.0,10063.95,Tuesday,2023-05-30 19:50:15
ONJPEE6QKQ,Michael Sanchez,Send Money,0.0,60.0,10563.95,Monday,2023-05-29 19:42:55
YDQF54T7PA,"Hill, Matthews and Martin",Till No,0.0,300.0,10623.95,Monday,2023-05-29 09:54:15
BEHO04EUXA,Mpesa Charges,Mpesa Charges,0.0,14.0,10923.95,Sunday,2023-05-28 20:23:30
VO92ZQIFDX,"Benitez, Palmer and Lane",Pay Bill,0.0,1193.0,10937.95,Sunday,2023-05-28 20:23:30
CR86WXKBNN,Shwari Withdraw,Mshwari Withdraw,4055.0,0.0,12130.95,Sunday,2023-05-28 13:39:07
QN1CTQHVR5,Mpesa Charges,Mpesa Charges,0.0,6.0,8075.95,Sunday,2023-05-28 13:29:49
NTG1VXYMZH,Marvin Castillo,Send Money,0.0,500.0,8081.95,Sunday,2023-05-28 13:29:49
LGCSJTU1IM,Janice Farley,Send Money,0.0,100.0,8581.95,Sunday,2023-05-28 11:02:24
X3ROCMR6DY,"Barajas, Cox and Reid",Pay Bill,0.0,100.0,8681.95,Sunday,2023-05-28 08:01:53
NEI672O23V,"Gomez, Rice and Simpson",Till No,0.0,1150.0,8781.95,Saturday,2023-05-27 20:47:38
OHFW68WPXV,Mpesa Charges,Mpesa Charges,0.0,55.0,9931.95,Saturday,2023-05-27 18:03:03
BUMXHU7QQ5,Katherine Garcia,Send Money,0.0,4000.0,9986.95,Saturday,2023-05-27 18:03:03
Y43VF6DWBM,"Anderson, Thompson and Evans",Till No,0.0,1095.0,13986.95,Saturday,2023-05-27 13:19:59
86AJSL1524,Vasquez-Powers,Till No,0.0,2200.0,15081.95,Saturday,2023-05-27 12:03:03
RB7I695WVR,Phillip Johnson,Send Money,0.0,20.0,17281.95,Saturday,2023-05-27 10:42:21
B1UTKA4D4W,Phillip Johnson,Send Money,0.0,50.0,17301.95,Saturday,2023-05-27 10:41:00
WR49U54X1D,Mpesa Charges,Mpesa Charges,0.0,65.0,17351.95,Friday,2023-05-26 19:55:59
QRPFY008R4,Cooper Group,Pay Bill,0.0,23100.0,17416.95,Friday,2023-05-26 19:55:59
77WL1IZHQ0,Fuentes-Hall,Bank Transfer,25000.0,0.0,40516.95,Friday,2023-05-26 19:54:22
KMJ1XV0MEY,Mpesa Charges,Mpesa Charges,0.0,6.0,15516.95,Friday,2023-05-26 19:38:50
2JWX16MCG9,Michael Sanchez,Send Money,0.0,105.0,15522.95,Friday,2023-05-26 19:38:50
1DKUG43C05,Mpesa Charges,Mpesa Charges,0.0,6.0,15627.95,Friday,2023-05-26 19:32:59
7YBF2XQ9I1,Ethan Williams,Send Money,0.0,150.0,15633.95,Friday,2023-05-26 19:32:59
RZALYZ7F5V,David Leon,Send Money,0.0,90.0,15783.95,Friday,2023-05-26 19:30:10
FQXS97XWEA,"Anderson, Thompson and Rogers",Till No,0.0,600.0,15873.95,Friday,2023-05-26 19:27:15
00VBIMXYBP,Henry-Dunn,Till No,0.0,200.0,16473.95,Friday,2023-05-26 19:05:38
1EXME66KXX,Mpesa Charges,Mpesa Charges,0.0,105.0,16673.95,Friday,2023-05-26 12:59:30
3E790T3J9X,Gordon and Sons,Pay Bill,0.0,60000.0,16778.95,Friday,2023-05-26 12:59:30
VCXADU6SFO,Shwari Withdraw,Mshwari Withdraw,60100.0,0.0,76778.95,Friday,2023-05-26 12:58:04
8ZEDQZACBM,"Barajas, Cox and Reid",Pay Bill,0.0,100.0,16678.95,Thursday,2023-05-25 16:41:40
KYUJY0CAPM,Nielsen and Sons,Till No,0.0,33950.0,16778.95,Thursday,2023-05-25 16:32:17
9DWKZLL1FA,Gilbert-Alexander,Bank Transfer,50000.0,0.0,50728.95,Thursday,2023-05-25 16:31:27
166JC4DA7I,Kim-Everett,Till No,0.0,5.0,728.95,Thursday,2023-05-25 08:25:11
ZKGGYH03RU,Kim-Everett,Till No,0.0,60.0,733.95,Thursday,2023-05-25 08:24:43
XZH27BQ9TW,Shwari Deposit,Mshwari Deposit,0.0,150000.0,793.95,Wednesday,2023-05-24 20:10:51
D0ZT6S9KIJ,"Aguirre, Gray and Gonzalez",Till No,0.0,450.0,150793.95,Wednesday,2023-05-24 20:08:45
WX2NZTLFSL,Mpesa Charges,Mpesa Charges,0.0,105.0,151243.95,Wednesday,2023-05-24 14:36:09
SCOB5Z2EO6,Reed PLC,Pay Bill,0.0,50000.0,151348.95,Wednesday,2023-05-24 14:36:09
L7MIZDFS3T,Chapman Group,Till No,0.0,400.0,1348.95,Tuesday,2023-05-23 18:34:54
H96MV03812,Miranda Davis,Send Money,0.0,80.0,1748.95,Tuesday,2023-05-23 18:27:29
6G2EJ05AWB,Mpesa Charges,Mpesa Charges,0.0,6.0,1828.95,Tuesday,2023-05-23 18:24:47
YSKTVGS4NN,Andrea Johnston,Send Money,0.0,170.0,1834.95,Tuesday,2023-05-23 18:24:47
O9LGX86R7E,Megan Moore,Send Money,0.0,100.0,2004.95,Tuesday,2023-05-23 18:22:15
RAE2Y7PVJD,"Barajas, Cox and Reid",Pay Bill,0.0,100.0,2104.95,Tuesday,2023-05-23 16:13:21
9DNAM7X2UM,Brian Hill,Receive Money,20.0,0.0,2204.95,Tuesday,2023-05-23 07:13:56
O39BVWR19I,Michael Sanchez,Send Money,0.0,70.0,2184.95,Monday,2023-05-22 19:34:54
ZHYHSD02NM,Mpesa Charges,Mpesa Charges,0.0,4.0,2254.95,Monday,2023-05-22 09:16:48
RZOBEPK65V,White-Fowler,Pay Bill,0.0,500.0,2258.95,Monday,2023-05-22 09:16:48
2662KKVBS6,Michael Sanchez,Send Money,0.0,100.0,2758.95,Saturday,2023-05-20 19:48:32
WALO3BA4BZ,Mpesa Charges,Mpesa Charges,0.0,6.0,2858.95,Saturday,2023-05-20 19:46:24
9FRZ9FO37N,Benjamin Villanueva,Send Money,0.0,200.0,2864.95,Saturday,2023-05-20 19:46:24
XGTHXAELOP,Baker-Franco,Till No,0.0,390.0,3064.95,Saturday,2023-05-20 19:42:53
5Q7KSLXSUQ,Mpesa Charges,Mpesa Charges,0.0,24.0,3454.95,Saturday,2023-05-20 16:18:55
GD3HXUX1SD,Williams and Sons,Pay Bill,0.0,2513.0,3478.95,Saturday,2023-05-20 16:18:55
ADWOFPWSLL,Shwari Withdraw,Mshwari Withdraw,5000.0,0.0,5991.95,Saturday,2023-05-20 16:18:30
AE3X2X8IID,Benjamin Villanueva,Send Money,0.0,90.0,991.95,Saturday,2023-05-20 14:27:36
BTPMP2RD31,"Johnson, Craig and Garcia",Till No,0.0,180.0,1081.95,Saturday,2023-05-20 14:25:00
GF8OUT445A,"Hill, Matthews and Martin",Till No,0.0,300.0,1261.95,Saturday,2023-05-20 14:18:02
OI8S4WZF47,"Johnson, Craig and Garcia",Till No,0.0,60.0,1561.95,Saturday,2023-05-20 09:51:03
3JMSDYVO8N,Mpesa Charges,Mpesa Charges,0.0,12.0,1621.95,Saturday,2023-05-20 01:42:14
MDLI2RAZSF,Daniel Erickson,Send Money,0.0,590.0,1633.95,Saturday,2023-05-20 01:42:14
VIDGVMIZZ2,Merritt and Sons,Till No,0.0,1400.0,2223.95,Saturday,2023-05-20 01:18:04
AJDG43H91C,Mpesa Charges,Mpesa Charges,0.0,9.0,3623.95,Saturday,2023-05-20 00:18:14
HW31ZLEHLS,Smith-Bishop,Pay Bill,0.0,850.0,3632.95,Saturday,2023-05-20 00:18:14
Q7PBUVEZAL,Mpesa Charges,Mpesa Charges,0.0,4.0,4482.95,Friday,2023-05-19 23:05:53
7TT3FFNYLJ,Smith-Bishop,Pay Bill,0.0,400.0,4486.95,Friday,2023-05-19 23:05:53
7OR6WD0BOU,Mpesa Charges,Mpesa Charges,0.0,9.0,4886.95,Friday,2023-05-19 22:38:04
GAOGIGLOE4,Smith-Bishop,Pay Bill,0.0,750.0,4895.95,Friday,2023-05-19 22:38:04
WP0HOS21WC,Mpesa Charges,Mpesa Charges,0.0,4.0,5645.95,Friday,2023-05-19 21:48:20
KWEEA7GS0O,Smith-Bishop,Pay Bill,0.0,400.0,5649.95,Friday,2023-05-19 21:48:20
JNSPB194KZ,Mpesa Charges,Mpesa Charges,0.0,4.0,6049.95,Friday,2023-05-19 21:04:35
8H2X31H3W5,Smith-Bishop,Pay Bill,0.0,400.0,6053.95,Friday,2023-05-19 21:04:35
PEZ8UGNJC0,Mpesa Charges,Mpesa Charges,0.0,9.0,6453.95,Friday,2023-05-19 20:52:20
U8ZK5W5JLG,Mclaughlin PLC,Pay Bill,0.0,1000.0,6462.95,Friday,2023-05-19 20:52:20
IEJORD9I9O,Mpesa Charges,Mpesa Charges,0.0,12.0,7462.95,Friday,2023-05-19 20:49:08
6II1LXYE72,Charles Casey,Send Money,0.0,630.0,7474.95,Friday,2023-05-19 20:49:08
9D05LJ5NNV,Ryan Edwards,Send Money,0.0,100.0,8104.95,Friday,2023-05-19 18:23:07
W8UP5808ZR,Conner Ltd,Till No,0.0,365.0,8204.95,Friday,2023-05-19 18:09:38
V9ZD1R6JNI,Mpesa Charges,Mpesa Charges,0.0,51.0,8569.95,Friday,2023-05-19 15:45:02
Q5LD11UYJW,Joseph Perez,Send Money,0.0,3300.0,8620.95,Friday,2023-05-19 15:45:02
RI5OCOXNEI,Dorothy Price,Send Money,0.0,3300.0,8620.95,Friday,2023-05-19 15:45:02
JLLSXD9B13,Hoffman Ltd,Bank Transfer,10000.0,0.0,11920.95,Friday,2023-05-19 15:43:41
OS9IPTYPX5,Mpesa Charges,Mpesa Charges,0.0,12.0,1920.95,Friday,2023-05-19 12:14:52
IZVUSCOHLZ,Kristin Lloyd,Send Money,0.0,619.0,1932.95,Friday,2023-05-19 12:14:52
TINY1LDWDU,Mpesa Charges,Mpesa Charges,0.0,32.0,2551.95,Thursday,2023-05-18 13:47:46
4R56SY8ZSL,Kristin Lloyd,Send Money,0.0,2330.0,2583.95,Thursday,2023-05-18 13:47:46
5TD0UVK0GD,Mpesa Charges,Mpesa Charges,0.0,14.0,4913.95,Wednesday,2023-05-17 20:53:46
VOORRCSP6W,"Benitez, Palmer and Lane",Pay Bill,0.0,1358.0,4927.95,Wednesday,2023-05-17 20:53:46
HT5WXQLO8G,Hamilton-Davenport,Bank Transfer,5000.0,0.0,6285.95,Wednesday,2023-05-17 20:44:05
0WWHQMJKLU,Mpesa Charges,Mpesa Charges,0.0,4.0,1285.95,Wednesday,2023-05-17 07:22:34
A4D7AJ1PE6,White-Fowler,Pay Bill,0.0,500.0,1289.95,Wednesday,2023-05-17 07:22:34
798YKIR1HW,Warren-Riley,Till No,0.0,700.0,1789.95,Tuesday,2023-05-16 21:48:09
HNYTJ8FZJC,Mpesa Charges,Mpesa Charges,0.0,32.0,2489.95,Tuesday,2023-05-16 20:20:28
65WHQ5CGQV,Marissa Taylor,Send Money,0.0,2268.0,2521.95,Tuesday,2023-05-16 20:20:28
ZOY3SY19EW,Michael Sanchez,Send Money,0.0,90.0,4789.95,Tuesday,2023-05-16 18:57:20
0L9O29OUYN,Mpesa Charges,Mpesa Charges,0.0,12.0,4879.95,Tuesday,2023-05-16 18:53:30
HGHAST8IKC,Vickie Orozco,Send Money,0.0,860.0,4891.95,Tuesday,2023-05-16 18:53:30
RT8PW11TMH,Mpesa Charges,Mpesa Charges,0.0,6.0,5751.95,Tuesday,2023-05-16 09:38:18
QI9H0W4M7I,Linda Calderon,Send Money,0.0,450.0,5757.95,Tuesday,2023-05-16 09:38:18
M3SQFHC0XG,Mpesa Charges,Mpesa Charges,0.0,32.0,6207.95,Monday,2023-05-15 20:04:11
O87Y1ZCVHR,Brian Nguyen,Send Money,0.0,1793.0,6239.95,Monday,2023-05-15 20:04:11
YO2LN9E86S,"Johnson, Craig and Garcia",Till No,0.0,250.0,8032.95,Monday,2023-05-15 19:53:07
82CXNTNIRV,Mpesa Charges,Mpesa Charges,0.0,22.0,8282.95,Monday,2023-05-15 08:20:46
TF8LDUA0TY,Elizabeth York,Send Money,0.0,1250.0,8304.95,Monday,2023-05-15 08:20:46
SW0CXMZB76,"Nguyen, Hawkins and Cantu",Till No,0.0,100.0,9554.95,Sunday,2023-05-14 18:37:45
TKQSKDKC66,Tanner Moore,Send Money,0.0,70.0,9654.95,Sunday,2023-05-14 18:31:41
5LD8ZZUGH9,Lopez-Rodgers,Till No,0.0,1550.0,9724.95,Sunday,2023-05-14 18:27:59
57HONF2FFD,Hall-Davis,Bank Transfer,10000.0,0.0,11274.95,Sunday,2023-05-14 18:25:44
I72B5HX90B,Mpesa Charges,Mpesa Charges,0.0,50.0,1274.95,Saturday,2023-05-13 16:13:39
4GVZGE6QX7,Larsen-Mullins,Cash Withdrawal,0.0,2800.0,1324.95,Saturday,2023-05-13 16:13:39
YZY8Y760B5,Mpesa Charges,Mpesa Charges,0.0,28.0,4124.95,Saturday,2023-05-13 15:53:44
B9DWCZZ06G,Patel and Sons,Cash Withdrawal,0.0,1350.0,4152.95,Saturday,2023-05-13 15:53:44
VCQUODNSQX,Mpesa Charges,Mpesa Charges,0.0,27.0,5502.95,Saturday,2023-05-13 15:36:31
EJNFS5O0G5,"Johnston, Coffey and Ellis",Cash Withdrawal,0.0,500.0,5529.95,Saturday,2023-05-13 15:36:31
FJOIL0RYG3,Mpesa Charges,Mpesa Charges,0.0,12.0,6029.95,Saturday,2023-05-13 15:11:40
WOYEENW2L9,George Smith,Send Money,0.0,550.0,6041.95,Saturday,2023-05-13 15:11:40
T6A1SE2R1F,Mpesa Charges,Mpesa Charges,0.0,12.0,6591.95,Saturday,2023-05-13 13:56:24
XF4M1534YG,Charles Davis,Send Money,0.0,650.0,6603.95,Saturday,2023-05-13 13:56:24
ML3L92T6GG,Mpesa Charges,Mpesa Charges,0.0,12.0,7253.95,Saturday,2023-05-13 12:10:41
IR0BD16KUF,Madison Johnson,Send Money,0.0,720.0,7265.95,Saturday,2023-05-13 12:10:41
B202TJ7W6J,"Sanders, Rogers and Kelly",Till No,0.0,1000.0,7985.95,Friday,2023-05-12 20:50:20
Y3BIWXLU8M,Mpesa Charges,Mpesa Charges,0.0,32.0,8985.95,Friday,2023-05-12 12:55:08
4DZQFJ5XI7,Brian Jones,Send Money,0.0,2148.0,9017.95,Friday,2023-05-12 12:55:08
1JOTBBHXTG,"Webb, Ramos and Rodgers",Bank Transfer,10000.0,0.0,11165.95,Friday,2023-05-12 12:49:44
HFNG5989FX,Mpesa Charges,Mpesa Charges,0.0,9.0,1165.95,Thursday,2023-05-11 21:00:10
JDF8SGW2OI,Davidson-Figueroa,Pay Bill,0.0,760.0,1174.95,Thursday,2023-05-11 21:00:10
YUZT4H58B0,Michael Sanchez,Send Money,0.0,90.0,1934.95,Thursday,2023-05-11 19:18:24
RJJITJFF5I,Yates-Dunn,Pay Bill,0.0,100.0,2024.95,Thursday,2023-05-11 19:16:38
H1R8BIUBPL,"Johnson, Craig and Garcia",Till No,0.0,60.0,2124.95,Thursday,2023-05-11 19:13:43
17YG1MKOF1,Mpesa Charges,Mpesa Charges,0.0,19.0,2184.95,Thursday,2023-05-11 13:22:19
3RBBM4K8L6,"Caldwell, King and Taylor",Pay Bill,0.0,1780.0,2203.95,Thursday,2023-05-11 13:22:19
O58LMRYSF9,Mpesa Charges,Mpesa Charges,0.0,12.0,5234.95,Tuesday,2023-05-09 22:24:12
72CWQ7IV0P,Brooke Hensley,Send Money,0.0,600.0,5246.95,Tuesday,2023-05-09 22:24:12
8UOCKCG67J,Merritt and Sons,Till No,0.0,650.0,5846.95,Tuesday,2023-05-09 21:45:55
DHNZ7Q7IEH,Mpesa Charges,Mpesa Charges,0.0,12.0,6496.95,Tuesday,2023-05-09 17:56:31
GMZF6OZR1W,Hannah Hernandez,Send Money,0.0,580.0,6508.95,Tuesday,2023-05-09 17:56:31
2K2QTSEDFH,"Johnson, Craig and Garcia",Till No,0.0,60.0,7088.95,Tuesday,2023-05-09 11:10:01
G118TCX0DL,Mpesa Charges,Mpesa Charges,0.0,22.0,7148.95,Monday,2023-05-08 21:12:47
CL5KC0MDU8,Christian Bennett,Send Money,0.0,1027.0,7170.95,Monday,2023-05-08 21:12:47
UUWTE1XVC8,Mpesa Charges,Mpesa Charges,0.0,55.0,8197.95,Monday,2023-05-08 16:20:23
4CF3XUE88G,Dean Curtis,Send Money,0.0,3700.0,8252.95,Monday,2023-05-08 16:20:23
N2SFD3NDL6,"Phillips, Peterson and King",Bank Transfer,10000.0,0.0,11952.95,Monday,2023-05-08 16:19:40
IPGTM6SU50,"Hill, Matthews and Martin",Till No,0.0,300.0,1952.95,Monday,2023-05-08 13:26:24
8MTDS9TF18,Mpesa Charges,Mpesa Charges,0.0,4.0,2252.95,Monday,2023-05-08 09:24:51
5EJ39WOH54,White-Fowler,Pay Bill,0.0,500.0,2256.95,Monday,2023-05-08 09:24:51
PZA2H0F4Q4,Michael Sanchez,Send Money,0.0,80.0,2756.95,Sunday,2023-05-07 16:19:41
8QE214I3AH,"Ho, Howell and Welch",Till No,0.0,130.0,2836.95,Sunday,2023-05-07 16:17:56
VEXH18MX5B,Mpesa Charges,Mpesa Charges,0.0,6.0,2966.95,Sunday,2023-05-07 16:15:46
7HQ4KHA3KZ,Madison Pugh,Send Money,0.0,120.0,2972.95,Sunday,2023-05-07 16:15:46
80PY1VA3B4,Jennifer Irwin,Send Money,0.0,70.0,3092.95,Sunday,2023-05-07 15:31:45
HALVBMT5NX,Margaret Wright,Send Money,0.0,30.0,3162.95,Sunday,2023-05-07 15:08:48
UZNLTE0CIX,Alicia Spence,Send Money,0.0,80.0,3192.95,Sunday,2023-05-07 14:14:40
WUP0O2PH71,Mpesa Charges,Mpesa Charges,0.0,12.0,3272.95,Sunday,2023-05-07 13:14:46
Y0DTJYAHY7,Luke Solomon,Send Money,0.0,850.0,3284.95,Sunday,2023-05-07 13:14:46
VBP5CBZY64,Airtime Purchase,Airtime Purchase,0.0,500.0,4134.95,Sunday,2023-05-07 11:00:02
7DKA5SERWQ,Moran LLC,Till No,0.0,80.0,4634.95,Sunday,2023-05-07 10:16:31
GMNVUJG6IL,Baker-Franco,Till No,0.0,800.0,4714.95,Saturday,2023-05-06 20:46:23
3VCGRV3K4T,Ryan Edwards,Send Money,0.0,50.0,5514.95,Saturday,2023-05-06 18:15:51
D3JXV66NNF,"Gomez, Rice and Simpson",Till No,0.0,2784.0,5564.95,Saturday,2023-05-06 18:09:19
MLC2490RVR,"Taylor, Williams and Lara",Till No,0.0,360.0,8348.95,Saturday,2023-05-06 18:00:39
KEXJEOYCIZ,Mpesa Charges,Mpesa Charges,0.0,6.0,8708.95,Saturday,2023-05-06 17:48:50
6GW1U1OQVT,Ryan Greene,Send Money,0.0,400.0,8714.95,Saturday,2023-05-06 17:48:50
RQ7W1UY4QT,Kimberly Hicks,Send Money,0.0,80.0,9114.95,Saturday,2023-05-06 17:42:04
0NTQVI06IS,Edwards and Sons,Pay Bill,0.0,210.0,9194.95,Saturday,2023-05-06 17:40:11
2NOWAMQCXV,Mpesa Charges,Mpesa Charges,0.0,6.0,9404.95,Saturday,2023-05-06 17:37:09
AZIHGMY6H0,Monica Estes,Send Money,0.0,200.0,9410.95,Saturday,2023-05-06 17:37:09
Z7DAAICIWE,Megan Moore,Send Money,0.0,100.0,9610.95,Saturday,2023-05-06 17:32:54
TVORRDKBUD,Michelle Juarez,Send Money,0.0,100.0,9710.95,Saturday,2023-05-06 17:31:35
9GGQ466IPN,Bell-Daniel,Till No,0.0,150.0,9810.95,Saturday,2023-05-06 17:29:05
Q2IJRZLEHI,Mpesa Charges,Mpesa Charges,0.0,6.0,9960.95,Saturday,2023-05-06 14:27:54
KYT45J8PSI,Robert Jones,Send Money,0.0,300.0,9966.95,Saturday,2023-05-06 14:27:54
AUHEGJM9ZE,Mpesa Charges,Mpesa Charges,0.0,70.0,10266.95,Saturday,2023-05-06 00:07:08
EXP2JQY4T8,"Caldwell, King and Taylor",Pay Bill,0.0,30000.0,10336.95,Saturday,2023-05-06 00:07:08
TKFX9UBWVH,"Medina, Hodges and Graves",Bank Transfer,20000.0,0.0,40336.95,Saturday,2023-05-06 00:05:47
H5ZWZVNZ7B,Patrick Ltd,Till No,0.0,400.0,20336.95,Friday,2023-05-05 19:43:37
1NRARWE2O9,Kaitlin Sanford,Send Money,0.0,80.0,20736.95,Friday,2023-05-05 18:13:10
AX8GX11GI6,Mpesa Charges,Mpesa Charges,0.0,6.0,20816.95,Friday,2023-05-05 12:19:31
SDYS53Z4ZA,David Martinez,Send Money,0.0,420.0,20822.95,Friday,2023-05-05 12:19:31
13QL8S9ZZF,Nichols LLC,Till No,0.0,1800.0,21242.95,Thursday,2023-05-04 23:03:04
A6VRJG17CP,Michael Sanchez,Send Money,0.0,70.0,23042.95,Thursday,2023-05-04 20:17:40
HWMV4SONGE,Mpesa Charges,Mpesa Charges,0.0,9.0,23112.95,Thursday,2023-05-04 13:46:21
X5H3YJLZUT,"Mills, Mccullough and Brown",Pay Bill,0.0,1000.0,23121.95,Thursday,2023-05-04 13:46:21
60EWY7QDWX,Diana Oliver,Send Money,0.0,50.0,24121.95,Wednesday,2023-05-03 18:40:03
9A3Y6LWOD7,"Gomez, Rice and Simpson",Till No,0.0,4118.0,24171.95,Wednesday,2023-05-03 18:34:22
PK0VL1ISI2,Juan Richmond,Send Money,0.0,100.0,28289.95,Wednesday,2023-05-03 17:40:21
VC86SYWAH8,Edwards and Sons,Pay Bill,0.0,1500.0,28389.95,Wednesday,2023-05-03 17:29:23
Q03VQ9RQJC,Mpesa Charges,Mpesa Charges,0.0,84.0,29889.95,Wednesday,2023-05-03 16:49:53
N19EK2FI6X,"Brooks, Kelly and Bell",Cash Withdrawal,0.0,7300.0,29973.95,Wednesday,2023-05-03 16:49:53
P4Q9QBC939,"Alvarez, Mann and Taylor",Till No,0.0,1500.0,37273.95,Wednesday,2023-05-03 16:21:31
IFJQH0IV7M,Justin Thomas,Pochi,0.0,60.0,38773.95,Wednesday,2023-05-03 15:05:03
P2FBNUMYBN,Shwari Withdraw,Mshwari Withdraw,1462.0,0.0,38833.95,Wednesday,2023-05-03 15:00:41
MYOKVNO5IU,"Robles, Kelley and Barr",Till No,0.0,950.0,37371.95,Wednesday,2023-05-03 14:43:22
ZC9JTEFHVX,Krueger-Best,Till No,0.0,20.0,38321.95,Wednesday,2023-05-03 14:01:50
OSYPFMGVWC,Mpesa Charges,Mpesa Charges,0.0,22.0,38341.95,Wednesday,2023-05-03 13:53:06
24UCBDN4ZN,Nathan Spencer,Send Money,0.0,1450.0,38363.95,Wednesday,2023-05-03 13:53:06
Q6W8TT4T3U,Michael Sanchez,Send Money,0.0,90.0,39813.95,Tuesday,2023-05-02 20:18:16
ZAQIAGZ2MY,"Ho, Howell and Welch",Till No,0.0,250.0,39903.95,Tuesday,2023-05-02 20:12:47
RY4SVIPTVK,Mpesa Charges,Mpesa Charges,0.0,6.0,40153.95,Tuesday,2023-05-02 18:35:15
LAFN64JF8N,Daniel Ellis,Send Money,0.0,170.0,40159.95,Tuesday,2023-05-02 18:35:15
O52T1XRTHE,Kayla Morris,Send Money,0.0,50.0,40329.95,Monday,2023-05-01 19:24:57
R00DT0RC4X,"Gomez, Rice and Simpson",Till No,0.0,1743.0,40379.95,Monday,2023-05-01 19:15:21
MU40KOARUJ,"Keith, Phillips and Singleton",Pay Bill,0.0,4100.0,42122.95,Monday,2023-05-01 15:47:08
BU3IIXVA9I,Mpesa Charges,Mpesa Charges,0.0,12.0,46222.95,Monday,2023-05-01 15:37:13
3PHLGWTGV5,Erica Smith,Send Money,0.0,740.0,46234.95,Monday,2023-05-01 15:37:13
Q20C0JOBO3,Mpesa Charges,Mpesa Charges,0.0,51.0,46974.95,Monday,2023-05-01 14:44:27
3JUFS3ORZA,Joseph Perez,Send Money,0.0,3000.0,47025.95,Monday,2023-05-01 14:44:27
KBUMMQ7YWL,Dorothy Price,Send Money,0.0,3000.0,47025.95,Monday,2023-05-01 14:44:27
717I0HG9SW,Other,Other,0.0,2000.0,50025.95,Monday,2023-05-01 14:42:42
DCPRHW1FBR,Roman LLC,Bank Transfer,50000.0,0.0,52025.95,Monday,2023-05-01 14:37:42
TOEZ79AITB,Mpesa Charges,Mpesa Charges,0.0,12.0,2025.95,Sunday,2023-04-30 18:50:02
7V6HMUGZM9,Tara Shaw,Send Money,0.0,800.0,2037.95,Sunday,2023-04-30 18:50:02
0Q81DWR398,Mpesa Charges,Mpesa Charges,0.0,12.0,2837.95,Saturday,2023-04-29 21:21:35
B2FDUVMVJJ,Jessica Bryan,Send Money,0.0,700.0,2849.95,Saturday,2023-04-29 21:21:35
X6HHNCMWKI,"Mays, Bennett and Griffin",Till No,0.0,200.0,3549.95,Saturday,2023-04-29 20:49:10
84LLSM5SZZ,Villarreal and Sons,Till No,0.0,1700.0,3749.95,Saturday,2023-04-29 20:28:33
3Q14ZWPYW0,Mpesa Charges,Mpesa Charges,0.0,9.0,5449.95,Saturday,2023-04-29 17:22:18
XLSS22WGJY,Yates-Dunn,Pay Bill,0.0,1000.0,5458.95,Saturday,2023-04-29 17:22:18
63FWESXIB8,Mpesa Charges,Mpesa Charges,0.0,12.0,6458.95,Saturday,2023-04-29 15:22:50
ATTTDPW4WI,Teresa Martinez,Send Money,0.0,800.0,6470.95,Saturday,2023-04-29 15:22:50
J2LV14PFRP,Stephenson Ltd,Till No,0.0,240.0,7270.95,Saturday,2023-04-29 10:05:33
UMT6GP2XOB,"Ellis, Glenn and Ayers",Till No,0.0,200.0,7510.95,Saturday,2023-04-29 10:03:49
V1QGK9CRH7,Mcgee-Palmer,Till No,0.0,210.0,7710.95,Saturday,2023-04-29 10:02:13
ODEX259P59,Mpesa Charges,Mpesa Charges,0.0,32.0,7920.95,Friday,2023-04-28 20:40:12
99AQEFCZ11,Matthew Fitzgerald,Send Money,0.0,2230.0,7952.95,Friday,2023-04-28 20:40:12
O16YC8PJU1,Griffin-Combs,Bank Transfer,10000.0,0.0,10182.95,Friday,2023-04-28 20:34:50
992IPB6TRJ,Mpesa Charges,Mpesa Charges,0.0,32.0,182.95,Friday,2023-04-28 15:43:26
RD6PH1H3MG,Andrew Weaver,Send Money,0.0,1808.0,214.95,Friday,2023-04-28 15:43:26
GY9PDQXQW5,Shwari Withdraw,Mshwari Withdraw,500.0,0.0,2022.95,Friday,2023-04-28 15:43:02
DSKU5EJ6U5,Mpesa Charges,Mpesa Charges,0.0,4.0,1522.95,Friday,2023-04-28 09:22:21
IUK7Z8RDJK,White-Fowler,Pay Bill,0.0,500.0,1526.95,Friday,2023-04-28 09:22:21
2JXC0M7SQE,Mpesa Charges,Mpesa Charges,0.0,32.0,2026.95,Thursday,2023-04-27 18:54:02
Q58U7J1X7Z,Kristin Gregory,Send Money,0.0,1970.0,2058.95,Thursday,2023-04-27 18:54:02
ZLVKBQ6O51,Mpesa Charges,Mpesa Charges,0.0,87.0,4028.95,Thursday,2023-04-27 12:11:21
ADCZ4NFXSJ,Jordan Rodriguez,Send Money,0.0,10000.0,4115.95,Thursday,2023-04-27 12:11:21
YRRHXQOARK,Shwari Withdraw,Mshwari Withdraw,10000.0,0.0,14115.95,Thursday,2023-04-27 12:10:51
MF6PKN9KF1,Michael Sanchez,Send Money,0.0,80.0,4115.95,Wednesday,2023-04-26 19:14:59
UE59L1LU82,Mpesa Charges,Mpesa Charges,0.0,22.0,4195.95,Wednesday,2023-04-26 15:04:32
2TRCDTTN05,Vincent Sanders,Send Money,0.0,1485.0,4217.95,Wednesday,2023-04-26 15:04:32
7I3H3WXDVX,Mpesa Charges,Mpesa Charges,0.0,55.0,5702.95,Wednesday,2023-04-26 12:35:35
82ZH5NXSJV,Joseph Perez,Send Money,0.0,5000.0,5757.95,Wednesday,2023-04-26 12:35:35
WFZ6HCO9K9,Dorothy Price,Send Money,0.0,5000.0,5757.95,Wednesday,2023-04-26 12:35:35
CFXQG2Z2YD,"Johnson, Craig and Garcia",Till No,0.0,60.0,10757.95,Wednesday,2023-04-26 11:04:13
M7XBIOF4Q8,Michael Sanchez,Send Money,0.0,50.0,10817.95,Tuesday,2023-04-25 20:02:18
8ESWE8GT6K,Baker-Franco,Till No,0.0,100.0,10867.95,Tuesday,2023-04-25 19:59:34
H24O4GAVAY,Mpesa Charges,Mpesa Charges,0.0,22.0,10967.95,Tuesday,2023-04-25 12:44:00
1SOMBRBAJZ,Jane Yoder,Send Money,0.0,1291.0,10989.95,Tuesday,2023-04-25 12:44:00
H4JI4CE29L,"Hill, Matthews and Martin",Till No,0.0,300.0,12280.95,Monday,2023-04-24 19:49:52
ZDE7JJB9K7,Alicia Chapman,Send Money,0.0,100.0,12580.95,Monday,2023-04-24 18:28:58
7HN74UDYID,Mpesa Charges,Mpesa Charges,0.0,55.0,12680.95,Monday,2023-04-24 16:57:58
WE1CNXU8CF,Christopher Cox,Send Money,0.0,3900.0,12735.95,Monday,2023-04-24 16:57:58
N9GIJGDZ70,Shwari Withdraw,Mshwari Withdraw,15000.0,0.0,16635.95,Monday,2023-04-24 16:56:13
GD032G7HNE,Brent Khan,Send Money,0.0,100.0,1635.95,Monday,2023-04-24 16:53:18
H3RUIOI337,Mpesa Charges,Mpesa Charges,0.0,22.0,1735.95,Monday,2023-04-24 13:19:08
GJ3RHIC7L9,Andrew Weaver,Send Money,0.0,1445.0,1757.95,Monday,2023-04-24 13:19:08
4SQVCC8RD3,Mpesa Charges,Mpesa Charges,0.0,32.0,3202.95,Sunday,2023-04-23 16:56:04
WHD3W6CO4Y,Angela Bowers,Send Money,0.0,1693.0,3234.95,Sunday,2023-04-23 16:56:04
WRUU26A2BT,Mpesa Charges,Mpesa Charges,0.0,6.0,4927.95,Sunday,2023-04-23 13:45:11
GZ5XIK5J5W,Jacob Marshall,Send Money,0.0,250.0,4933.95,Sunday,2023-04-23 13:45:11
HI7NM5BNZS,Mpesa Charges,Mpesa Charges,0.0,12.0,5183.95,Saturday,2023-04-22 16:54:17
ZKCJYNJJ4J,Matthew Price,Send Money,0.0,860.0,5195.95,Saturday,2023-04-22 16:54:17
PILAIBFAGJ,Mpesa Charges,Mpesa Charges,0.0,19.0,6055.95,Saturday,2023-04-22 12:34:00
JF2ZZ0MSUV,"Peterson, Welch and Cisneros",Pay Bill,0.0,1600.0,6074.95,Saturday,2023-04-22 12:34:00
G8DM7W4R0C,Stephanie Reyes,Send Money,0.0,50.0,7674.95,Saturday,2023-04-22 11:25:15
IZ736NQWMB,Jones-Anderson,Till No,0.0,4500.0,7724.95,Friday,2023-04-21 22:36:12
CAH35AVQBT,Jeremy Simmons,Receive Money,900.0,0.0,12224.95,Friday,2023-04-21 22:25:32
9DVKH4J0ME,Hector Kramer,Receive Money,1200.0,0.0,11324.95,Friday,2023-04-21 22:23:40
60LZS0FY65,Theresa Kelly,Receive Money,1200.0,0.0,11324.95,Friday,2023-04-21 22:23:40
QQBDGEY923,Michael Suarez,Receive Money,1500.0,0.0,10124.95,Friday,2023-04-21 22:22:23
C58MY6OIQJ,Derrick Fischer,Receive Money,1500.0,0.0,10124.95,Friday,2023-04-21 22:22:23
R8KVC8JZ0R,Mpesa Charges,Mpesa Charges,0.0,12.0,8624.95,Friday,2023-04-21 18:50:38
D9IKNT0GAH,Jennifer Irwin,Send Money,0.0,740.0,8636.95,Friday,2023-04-21 18:50:38
721BY8GV2X,Mpesa Charges,Mpesa Charges,0.0,6.0,9376.95,Friday,2023-04-21 16:20:20
V2VZO66P1B,Lisa Sanchez,Send Money,0.0,150.0,9382.95,Friday,2023-04-21 16:20:20
W0N57I7XFM,"Ho, Howell and Welch",Till No,0.0,110.0,9532.95,Thursday,2023-04-20 21:02:16
YHIYTB5DGE,Mpesa Charges,Mpesa Charges,0.0,6.0,9642.95,Thursday,2023-04-20 20:58:52
I5TZSPE0BX,Richard Pacheco,Send Money,0.0,450.0,9648.95,Thursday,2023-04-20 20:58:52
CZ4ITSI5RW,"Carlson, Smith and Thomas",Till No,0.0,198.0,10098.95,Thursday,2023-04-20 20:15:58
2F8DENRTGD,"Carlson, Smith and Thomas",Till No,0.0,1562.0,10296.95,Thursday,2023-04-20 20:14:57
VH0XUIQFKS,Shwari Withdraw,Mshwari Withdraw,10000.0,0.0,11858.95,Thursday,2023-04-20 20:13:25
DF50PK1Y0W,Cynthia Gomez,Pochi,0.0,60.0,1858.95,Thursday,2023-04-20 19:45:06
G4FKI5FN7D,Mpesa Charges,Mpesa Charges,0.0,6.0,1918.95,Thursday,2023-04-20 18:06:25
3JM3SIVOOL,Vickie Gutierrez,Send Money,0.0,450.0,1924.95,Thursday,2023-04-20 18:06:25
RAKMRZ2J1F,Mpesa Charges,Mpesa Charges,0.0,12.0,2374.95,Wednesday,2023-04-19 22:31:18
RJW5MWBT8D,Joseph Perez,Send Money,0.0,900.0,2386.95,Wednesday,2023-04-19 22:31:18
WM7J0YG2PC,Dorothy Price,Send Money,0.0,900.0,2386.95,Wednesday,2023-04-19 22:31:18
9U9A53SNTT,Michael Sanchez,Send Money,0.0,100.0,3286.95,Wednesday,2023-04-19 18:12:37
TGFGQ7MSD5,Shawn Hamilton,Send Money,0.0,80.0,3386.95,Wednesday,2023-04-19 18:10:20
ZKFWDVKQ0Z,"Anderson, Thompson and Rogers",Till No,0.0,400.0,3466.95,Wednesday,2023-04-19 18:04:22
PZS1XIWXWK,Mpesa Charges,Mpesa Charges,0.0,6.0,3866.95,Tuesday,2023-04-18 18:45:38
GID9MKPPZT,Shawn Hamilton,Send Money,0.0,120.0,3872.95,Tuesday,2023-04-18 18:45:38
72WOTO0CXV,Mpesa Charges,Mpesa Charges,0.0,97.0,3992.95,Tuesday,2023-04-18 18:31:09
V565KGTDUQ,Christopher Cox,Send Money,0.0,14000.0,4089.95,Tuesday,2023-04-18 18:31:09
CJUSQ44Y9P,Shwari Withdraw,Mshwari Withdraw,15000.0,0.0,18089.95,Tuesday,2023-04-18 18:27:18
QU5FBXBBUB,Mpesa Charges,Mpesa Charges,0.0,4.0,3089.95,Tuesday,2023-04-18 10:01:29
PJWOOJ5LN3,White-Fowler,Pay Bill,0.0,500.0,3093.95,Tuesday,2023-04-18 10:01:29
GIXWABVBWK,"Ho, Howell and Welch",Till No,0.0,210.0,3593.95,Monday,2023-04-17 20:07:28
RIP9RRJV4H,"Johnson, Craig and Garcia",Till No,0.0,60.0,3803.95,Monday,2023-04-17 20:05:09
FAQ027Y3H9,James Moreno,Send Money,0.0,80.0,3863.95,Monday,2023-04-17 19:50:11
4Z5H83VRHU,Rose Reyes,Send Money,0.0,100.0,3943.95,Monday,2023-04-17 17:04:19
XRNAQ6SH1Z,Reid Ltd,Pay Bill,0.0,500.0,4043.95,Monday,2023-04-17 16:50:25
3FL5DA0UCR,Kevin Flores DDS,Send Money,0.0,100.0,4543.95,Monday,2023-04-17 15:50:24
P8W2VSUQBE,Javier Hamilton,Send Money,0.0,50.0,4643.95,Sunday,2023-04-16 20:08:28
N2Y1PD5QTT,"Johnson, Craig and Garcia",Till No,0.0,180.0,4693.95,Sunday,2023-04-16 19:50:14
VZF1KDQRFM,Mpesa Charges,Mpesa Charges,0.0,32.0,4873.95,Sunday,2023-04-16 19:00:01
MME67D68UX,Jason Fernandez,Send Money,0.0,1700.0,4905.95,Sunday,2023-04-16 19:00:01
595S24WUGK,Davis Ltd,Bank Transfer,6000.0,0.0,6605.95,Sunday,2023-04-16 17:52:29
AIAGHRHXN1,Mpesa Charges,Mpesa Charges,0.0,6.0,605.95,Saturday,2023-04-15 14:58:23
1595T37AG6,Richard Delacruz,Send Money,0.0,300.0,611.95,Saturday,2023-04-15 14:58:23
K2CRVCNFBJ,Mpesa Charges,Mpesa Charges,0.0,40.0,911.95,Friday,2023-04-14 09:30:56
0RVLX1UDSG,"Smith, Wagner and Cortez",Pay Bill,0.0,7500.0,951.95,Friday,2023-04-14 09:30:56
4HEFK4DXJ8,"Pitts, Bennett and Smith",Till No,0.0,150.0,8451.95,Wednesday,2023-04-12 16:45:28
BZLKP7FNQE,Mpesa Charges,Mpesa Charges,0.0,12.0,8601.95,Wednesday,2023-04-12 13:00:52
B7OYDDLGKD,Shannon Sims,Send Money,0.0,1000.0,8613.95,Wednesday,2023-04-12 13:00:52
MZ0RPSXX6H,Mpesa Charges,Mpesa Charges,0.0,9.0,9613.95,Monday,2023-04-10 19:35:59
ZG5NQA7LZE,Davidson-Figueroa,Pay Bill,0.0,760.0,9622.95,Monday,2023-04-10 19:35:59
V5A67VLVYK,Pearson-Dunlap,Bank Transfer,10000.0,0.0,10382.95,Monday,2023-04-10 19:31:11
YB7450I7U9,Manning-Perez,Till No,0.0,1650.0,382.95,Sunday,2023-04-09 18:25:20
JKL390S4XR,Mpesa Charges,Mpesa Charges,0.0,12.0,2032.95,Thursday,2023-04-06 14:17:09
PH2ICGHREH,Jessica Long,Send Money,0.0,850.0,2044.95,Thursday,2023-04-06 14:17:09
IT6OAOK3HW,Mpesa Charges,Mpesa Charges,0.0,22.0,2894.95,Thursday,2023-04-06 10:49:28
ART0ZRHDKK,Nicole Webb,Send Money,0.0,1500.0,2916.95,Thursday,2023-04-06 10:49:28
SC545VIUWD,Mpesa Charges,Mpesa Charges,0.0,4.0,4416.95,Wednesday,2023-04-05 20:25:57
NRS0CQPWDF,White-Fowler,Pay Bill,0.0,500.0,4420.95,Wednesday,2023-04-05 20:25:57
8YTN2L0XHE,Laurie Armstrong,Send Money,0.0,40.0,4920.95,Wednesday,2023-04-05 17:35:50
SS397WFVPR,"Smith, Kennedy and Taylor",Till No,0.0,80.0,4960.95,Wednesday,2023-04-05 17:30:49
3NYU4RBDUX,Christine Smith,Send Money,0.0,50.0,5040.95,Wednesday,2023-04-05 17:24:59
WX61T8F98B,Mpesa Charges,Mpesa Charges,0.0,12.0,5090.95,Wednesday,2023-04-05 16:52:02
4U2L8RQK02,Joseph Perez,Send Money,0.0,700.0,5102.95,Wednesday,2023-04-05 16:52:02
BPJR4MERD5,Dorothy Price,Send Money,0.0,700.0,5102.95,Wednesday,2023-04-05 16:52:02
3I8OVOUT61,Mpesa Charges,Mpesa Charges,0.0,6.0,5802.95,Tuesday,2023-04-04 20:36:12
M1GR5T61NR,Michael Sanchez,Send Money,0.0,150.0,5808.95,Tuesday,2023-04-04 20:36:12
FA2CSLEUYX,Robert Carpenter,Send Money,0.0,100.0,5958.95,Tuesday,2023-04-04 20:00:03
2TEGGTQ0IA,"Anderson, Thompson and Rogers",Till No,0.0,650.0,6058.95,Tuesday,2023-04-04 19:45:21
B4MJFDO647,"Perez, Key and Anderson",Till No,0.0,100.0,6708.95,Tuesday,2023-04-04 17:29:27
TQVSQ7GVNT,"Johnson, Craig and Garcia",Till No,0.0,60.0,6808.95,Tuesday,2023-04-04 08:45:52
4YAZB51SAA,Michael Sanchez,Send Money,0.0,40.0,6868.95,Monday,2023-04-03 19:07:17
5AG7QLKDMM,Mpesa Charges,Mpesa Charges,0.0,105.0,6908.95,Monday,2023-04-03 13:44:41
EN6KP4IKRM,Gordon and Sons,Pay Bill,0.0,78000.0,7013.95,Monday,2023-04-03 13:44:41
41ZJCBFV45,Shwari Withdraw,Mshwari Withdraw,78200.0,0.0,85013.95,Monday,2023-04-03 13:41:24
6XO5UYX9CP,Mpesa Charges,Mpesa Charges,0.0,75.0,6813.95,Monday,2023-04-03 11:50:04
7FPIKHL7GV,Roy Brown,Send Money,0.0,6900.0,6888.95,Monday,2023-04-03 11:50:04
IW46KEYGOQ,Rebecca Hicks,Send Money,0.0,6900.0,6888.95,Monday,2023-04-03 11:50:04
K7RVABDSB9,Mpesa Charges,Mpesa Charges,0.0,6.0,13788.95,Sunday,2023-04-02 19:34:11
DSJ08BOU82,Kristen Wood,Send Money,0.0,370.0,13794.95,Sunday,2023-04-02 19:34:11
LI9T7YN72O,Reeves-Copeland,Till No,0.0,10957.0,14164.95,Sunday,2023-04-02 19:05:56
SP60BD828T,"Hill, Matthews and Martin",Till No,0.0,300.0,25121.95,Sunday,2023-04-02 15:14:22
M6SVVJMTNA,Mcgee-Palmer,Till No,0.0,290.0,25421.95,Sunday,2023-04-02 10:52:09
8H4N9K4ZM7,Mpesa Charges,Mpesa Charges,0.0,6.0,25711.95,Saturday,2023-04-01 23:12:03
ZWCWKVZN0T,Christopher Walker,Send Money,0.0,270.0,25717.95,Saturday,2023-04-01 23:12:03
XRKAZ0DYOP,Mpesa Charges,Mpesa Charges,0.0,6.0,25987.95,Saturday,2023-04-01 22:43:46
NV4DPS8554,Harold White,Send Money,0.0,300.0,25993.95,Saturday,2023-04-01 22:43:46
2SQ0XGXKCM,Moreno LLC,Till No,0.0,8450.0,26293.95,Saturday,2023-04-01 22:41:15
YBSR93CXV0,Mpesa Charges,Mpesa Charges,0.0,6.0,34743.95,Saturday,2023-04-01 20:03:00
3XIMT032EV,April Wade,Send Money,0.0,420.0,34749.95,Saturday,2023-04-01 20:03:00
IZ0Z5NLGX9,Airtime Purchase,Airtime Purchase,0.0,500.0,35169.95,Saturday,2023-04-01 11:03:55
UP8AQQNEPF,Mpesa Charges,Mpesa Charges,0.0,87.0,35669.95,Saturday,2023-04-01 11:00:44
3ZC6OLUWHA,Harold King,Send Money,0.0,8000.0,35756.95,Saturday,2023-04-01 11:00:44
UB3LLFGRS6,Mpesa Charges,Mpesa Charges,0.0,80.0,43756.95,Saturday,2023-04-01 10:56:57
Y8CHW72SL0,"Caldwell, King and Taylor",Pay Bill,0.0,30420.0,43836.95,Saturday,2023-04-01 10:56:57
I6Y4498XSU,"Keith, Phillips and Singleton",Pay Bill,0.0,2999.0,74256.95,Saturday,2023-04-01 10:52:37
KZMZVR0TYQ,White Ltd,Bank Transfer,75000.0,0.0,77255.95,Saturday,2023-04-01 10:47:04
6AUWK03J89,"Johnson, Craig and Garcia",Till No,0.0,170.0,2255.95,Saturday,2023-04-01 09:40:26
07EFTHLP9O,Mpesa Charges,Mpesa Charges,0.0,4.0,2425.95,Friday,2023-03-31 21:24:07
AHH2E4WTX8,White-Fowler,Pay Bill,0.0,200.0,2429.95,Friday,2023-03-31 21:24:07
NL3T4TOYMW,Mpesa Charges,Mpesa Charges,0.0,32.0,2629.95,Friday,2023-03-31 20:28:52
RXCLJSSTYK,Shelley Holt,Send Money,0.0,2370.0,2661.95,Friday,2023-03-31 20:28:52
CU6Y1C12Q3,Roy Brown,Receive Money,3000.0,0.0,5031.95,Friday,2023-03-31 19:20:41
FD9UFY6737,Rebecca Hicks,Receive Money,3000.0,0.0,5031.95,Friday,2023-03-31 19:20:41
JZX2XU6VE3,Mpesa Charges,Mpesa Charges,0.0,22.0,2031.95,Friday,2023-03-31 10:46:37
X8QBFRPYQN,Andrew Weaver,Send Money,0.0,1331.0,2053.95,Friday,2023-03-31 10:46:37
8QMKUIA1NA,Mpesa Charges,Mpesa Charges,0.0,32.0,3384.95,Thursday,2023-03-30 21:17:25
BOHQ8OGXGM,Tanya Hubbard,Send Money,0.0,1943.0,3416.95,Thursday,2023-03-30 21:17:25
ZQICT6UFIP,Mpesa Charges,Mpesa Charges,0.0,32.0,5359.95,Thursday,2023-03-30 10:45:09
N5JMX9CDU7,Leah Carson,Send Money,0.0,1595.0,5391.95,Thursday,2023-03-30 10:45:09
SXSO1JJWF4,Mpesa Charges,Mpesa Charges,0.0,6.0,6986.95,Wednesday,2023-03-29 17:28:31
C3X62MPY7F,Shawn Hamilton,Send Money,0.0,190.0,6992.95,Wednesday,2023-03-29 17:28:31
V98GRZAXK6,Mpesa Charges,Mpesa Charges,0.0,22.0,7182.95,Wednesday,2023-03-29 12:35:33
W5EN79KOQX,Eric Duran,Send Money,0.0,1238.0,7204.95,Wednesday,2023-03-29 12:35:33
2QNNM47IX5,"Johnson, Craig and Garcia",Till No,0.0,250.0,8442.95,Tuesday,2023-03-28 19:31:31
OTH5GXKKV2,Mpesa Charges,Mpesa Charges,0.0,32.0,8692.95,Tuesday,2023-03-28 15:56:12
QRNQG29SAN,Jackson Acosta,Send Money,0.0,2118.0,8724.95,Tuesday,2023-03-28 15:56:12
3FO1CK3KFI,Mpesa Charges,Mpesa Charges,0.0,6.0,10842.95,Tuesday,2023-03-28 12:25:54
ZHZ1TCXUUV,Joseph Perez,Send Money,0.0,450.0,10848.95,Tuesday,2023-03-28 12:25:54
R0WQEW10R5,Dorothy Price,Send Money,0.0,450.0,10848.95,Tuesday,2023-03-28 12:25:54
F585U9G4L6,Michael Sanchez,Send Money,0.0,75.0,11298.95,Monday,2023-03-27 20:00:28
3SYJBIVGS6,Mpesa Charges,Mpesa Charges,0.0,32.0,11373.95,Sunday,2023-03-26 20:40:21
T47K51EXBE,Patricia Stewart,Send Money,0.0,1658.0,11405.95,Sunday,2023-03-26 20:40:21
FSE9WER0HZ,Reid Ltd,Pay Bill,0.0,2000.0,13063.95,Sunday,2023-03-26 20:32:34
OJ21T939BE,"Phillips, Nguyen and Ellis",Bank Transfer,15000.0,0.0,15063.95,Sunday,2023-03-26 20:30:23
ITA6SPCQR2,Mpesa Charges,Mpesa Charges,0.0,33.0,63.95,Sunday,2023-03-26 19:02:50
QNYPRMYQ94,Yates-Dunn,Pay Bill,0.0,5000.0,96.95,Sunday,2023-03-26 19:02:50
O4TNVLYU2A,Walker Inc,Till No,0.0,150.0,5096.95,Sunday,2023-03-26 16:01:52
4MT0HD372Q,Mpesa Charges,Mpesa Charges,0.0,22.0,5246.95,Saturday,2023-03-25 20:12:30
TJ7O8XQT0N,Chelsea Jackson,Send Money,0.0,1468.0,5268.95,Saturday,2023-03-25 20:12:30
MWZSXYVQ7K,Mpesa Charges,Mpesa Charges,0.0,6.0,6736.95,Saturday,2023-03-25 17:51:00
Y0YGBM0X3G,Daniel Ellis,Send Money,0.0,140.0,6742.95,Saturday,2023-03-25 17:51:00
U7GEIYPFGD,Mpesa Charges,Mpesa Charges,0.0,32.0,6882.95,Friday,2023-03-24 20:59:31
FFY90YMGNX,Elizabeth Archer,Send Money,0.0,1517.0,6914.95,Friday,2023-03-24 20:59:31
PYNT9LT41R,Mcgee-Palmer,Till No,0.0,1670.0,8431.95,Friday,2023-03-24 09:02:55
ZJG4C0M40B,Garcia-Jennings,Bank Transfer,10000.0,0.0,10101.95,Friday,2023-03-24 08:58:13
NPYJFLK63B,Mpesa Charges,Mpesa Charges,0.0,22.0,101.95,Thursday,2023-03-23 19:33:47
YFN1IYA300,Joseph Perez,Send Money,0.0,1500.0,123.95,Thursday,2023-03-23 19:33:47
ETWKMIFVY8,Dorothy Price,Send Money,0.0,1500.0,123.95,Thursday,2023-03-23 19:33:47
I5TY5PZBAI,"Hill, Matthews and Martin",Till No,0.0,300.0,1623.95,Thursday,2023-03-23 12:26:16
UMFT1VLX67,Mpesa Charges,Mpesa Charges,0.0,4.0,1923.95,Thursday,2023-03-23 09:50:31
N21ANVLQ25,White-Fowler,Pay Bill,0.0,500.0,1927.95,Thursday,2023-03-23 09:50:31
4BWCGC8USY,Mpesa Charges,Mpesa Charges,0.0,12.0,2427.95,Wednesday,2023-03-22 22:03:35
Z293EAPVV7,Joseph Perez,Send Money,0.0,900.0,2439.95,Wednesday,2023-03-22 22:03:35
RZW6ATOTOC,Dorothy Price,Send Money,0.0,900.0,2439.95,Wednesday,2023-03-22 22:03:35
AFZRA3RNV5,Michael Sanchez,Send Money,0.0,40.0,3339.95,Wednesday,2023-03-22 11:28:14
3JMIYV64JG,Lindsey Johnson,Send Money,0.0,70.0,3379.95,Wednesday,2023-03-22 11:25:51
LJUYT8ARBQ,"Johnson, Craig and Garcia",Till No,0.0,120.0,3449.95,Wednesday,2023-03-22 11:23:32
WVFSVS29XZ,Mpesa Charges,Mpesa Charges,0.0,22.0,3569.95,Wednesday,2023-03-22 10:54:17
T78R5VWGMD,Jon Armstrong,Send Money,0.0,1457.0,3591.95,Wednesday,2023-03-22 10:54:17
62YTY8LMJ2,"Anderson, Thompson and Rogers",Till No,0.0,670.0,5048.95,Tuesday,2023-03-21 18:55:36
